two_words,cnt_in_true,cnt_in_fake,freq_true,freq_fake,total_cnt
"('of', 'the')",2522,1816,0.023506603659275416,0.03596466906959243,4338
"('not', 'a')",4165,57,0.038820382331832715,0.0011288469917217886,4222
"('in', 'the')",1600,2032,0.014912992012228654,0.040242405038222365,3632
"('hes', 'not')",3240,22,0.030198808824763022,0.00043569533013823424,3262
"('illegal', 'alien')",3174,1,0.029583647904258593,1.9804333188101555e-05,3175
"('charged', 'with')",3026,33,0.02820419614312744,0.0006535429952073513,3059
"('this', 'is')",1158,1875,0.010793277968850488,0.03713312472769042,3033
"('to', 'miss')",3010,1,0.028055066223005153,1.9804333188101555e-05,3011
"('super', 'bowl')",2945,1,0.027449225922508366,1.9804333188101555e-05,2946
"('donald', 'trump')",2489,414,0.0231990231990232,0.008198993939874045,2903
"('fake', 'news')",2786,65,0.025967247341293142,0.0012872816572266012,2851
"('child', 'porn')",2631,195,0.024522551240108492,0.0038618449716798036,2826
"('trump', 'administration')",1589,1162,0.014810465192144582,0.023012635164574007,2751
"('surrounded', 'by')",2688,9,0.02505382658054414,0.000178238998692914,2697
"('walls', 'and')",2661,1,0.02480216984033778,1.9804333188101555e-05,2662
"('anti', 'gun')",2654,1,0.02473692550028428,1.9804333188101555e-05,2655
"('armed', 'guards')",2653,1,0.024727604880276637,1.9804333188101555e-05,2654
"('gun', 'hollywood')",2652,1,0.024718284260268994,1.9804333188101555e-05,2653
"('and', 'armed')",2652,1,0.024718284260268994,1.9804333188101555e-05,2653
"('security', 'walls')",2652,1,0.024718284260268994,1.9804333188101555e-05,2653
"('hollywood', 'surrounded')",2651,1,0.02470896364026135,1.9804333188101555e-05,2652
"('by', 'security')",2651,1,0.02470896364026135,1.9804333188101555e-05,2652
"('golden', 'globes')",2650,1,0.02469964302025371,1.9804333188101555e-05,2651
"('globes', 'anti')",2650,1,0.02469964302025371,1.9804333188101555e-05,2651
"('school', 'worker')",2597,1,0.024205650159848633,1.9804333188101555e-05,2598
"('alien', 'school')",2596,1,0.02419632953984099,1.9804333188101555e-05,2597
"('california', 'illegal')",2595,1,0.024187008919833348,1.9804333188101555e-05,2596
"('worker', 'charged')",2595,1,0.024187008919833348,1.9804333188101555e-05,2596
"('porn', 'possession')",2595,1,0.024187008919833348,1.9804333188101555e-05,2596
"('with', 'child')",2595,1,0.024187008919833348,1.9804333188101555e-05,2596
"('mainstream', 'media')",2148,410,0.020020691776416966,0.008119776607121638,2558
"('of', 'fake')",2538,6,0.0236557335793977,0.00011882599912860934,2544
"('will', 'take')",2534,5,0.02361845109936713,9.902166594050779e-05,2539
"('buildthewall', 'deportthemall')",2439,1,0.022732992198641052,1.9804333188101555e-05,2440
"('the', 'real')",2297,12,0.02140946415755576,0.0002376519982572187,2309
"('i', 'will')",2226,69,0.020747700137013114,0.0013664989899790075,2295
"('covington', 'catholic')",2290,1,0.02134421981750226,1.9804333188101555e-05,2291
"('who', 'the')",2283,5,0.02127897547744876,9.902166594050779e-05,2288
"('away', 'with')",2229,54,0.02077566199703604,0.001069433992157484,2283
"('target', 'of')",2275,5,0.021204410517387615,9.902166594050779e-05,2280
"('truly', 'is')",2275,4,0.021204410517387615,7.921733275240622e-05,2279
"('real', 'target')",2275,1,0.021204410517387615,1.9804333188101555e-05,2276
"('news', 'truly')",2275,1,0.021204410517387615,1.9804333188101555e-05,2276
"('shows', 'who')",2275,1,0.021204410517387615,1.9804333188101555e-05,2276
"('hoax', 'shows')",2275,1,0.021204410517387615,1.9804333188101555e-05,2276
"('catholic', 'hoax')",2275,1,0.021204410517387615,1.9804333188101555e-05,2276
"('trump', 'jr')",2275,1,0.021204410517387615,1.9804333188101555e-05,2276
"('jr', 'covington')",2274,1,0.021195089897379973,1.9804333188101555e-05,2275
"('is', 'breitbart')",2238,1,0.02085954757710483,1.9804333188101555e-05,2239
"('across', 'our')",2226,1,0.020747700137013114,1.9804333188101555e-05,2227
"('border', 'by')",2225,1,0.02073837951700547,1.9804333188101555e-05,2226
"('brought', 'in')",2224,2,0.02072905889699783,3.960866637620311e-05,2226
"('drug', 'cartels')",2224,1,0.02072905889699783,1.9804333188101555e-05,2225
"('open', 'border')",2224,1,0.02072905889699783,1.9804333188101555e-05,2225
"('wide', 'open')",2224,1,0.02072905889699783,1.9804333188101555e-05,2225
"('in', 'by')",2223,1,0.020719738276990186,1.9804333188101555e-05,2224
"('mexican', 'drug')",2222,1,0.020710417656982543,1.9804333188101555e-05,2223
"('by', 'mexican')",2222,1,0.020710417656982543,1.9804333188101555e-05,2223
"('no', 'brought')",2222,1,0.020710417656982543,1.9804333188101555e-05,2223
"('overstayers', 'no')",2222,1,0.020710417656982543,1.9804333188101555e-05,2223
"('visa', 'overstayers')",2222,1,0.020710417656982543,1.9804333188101555e-05,2223
"('by', 'visa')",2222,1,0.020710417656982543,1.9804333188101555e-05,2223
"('our', 'wide')",2222,1,0.020710417656982543,1.9804333188101555e-05,2223
"('brought', 'across')",2222,1,0.020710417656982543,1.9804333188101555e-05,2223
"('on', 'the')",1026,1176,0.009562956127841624,0.02328989582920743,2202
"('to', 'a')",146,2010,0.0013608105211158647,0.03980670970808413,2156
"('russell', 'westbrook')",2140,1,0.019946126816355825,1.9804333188101555e-05,2141
"('to', 'enter')",862,1269,0.008034374446588187,0.025131698815700876,2131
"('search', 'engine')",2127,1,0.019824958756256467,1.9804333188101555e-05,2128
"('late', 'after')",2123,1,0.019787676276225893,1.9804333188101555e-05,2124
"('after', 'practice')",2123,1,0.019787676276225893,1.9804333188101555e-05,2124
"('100', 'extra')",2123,1,0.019787676276225893,1.9804333188101555e-05,2124
"('miss', '100')",2123,1,0.019787676276225893,1.9804333188101555e-05,2124
"('practice', 'to')",2123,1,0.019787676276225893,1.9804333188101555e-05,2124
"('dedicated', 'russell')",2123,1,0.019787676276225893,1.9804333188101555e-05,2124
"('westbrook', 'stays')",2123,1,0.019787676276225893,1.9804333188101555e-05,2124
"('stays', 'late')",2123,1,0.019787676276225893,1.9804333188101555e-05,2124
"('extra', 'shots')",2122,1,0.01977835565621825,1.9804333188101555e-05,2123
"('the', 'cnn')",2113,1,0.019694470076149464,1.9804333188101555e-05,2114
"('with', 'executive')",2112,1,0.01968514945614182,1.9804333188101555e-05,2113
"('gun', 'dealers')",2111,1,0.01967582883613418,1.9804333188101555e-05,2112
"('licenses', 'away')",2109,1,0.019657187596118893,1.9804333188101555e-05,2110
"('favor', 'mainstream')",2109,1,0.019657187596118893,1.9804333188101555e-05,2110
"('overwhelmingly', 'favor')",2109,1,0.019657187596118893,1.9804333188101555e-05,2110
"('results', 'overwhelmingly')",2109,1,0.019657187596118893,1.9804333188101555e-05,2110
"('take', 'gun')",2109,1,0.019657187596118893,1.9804333188101555e-05,2110
"('dealers', 'licenses')",2109,1,0.019657187596118893,1.9804333188101555e-05,2110
"('cnn', 'search')",2109,1,0.019657187596118893,1.9804333188101555e-05,2110
"('if', 'elected')",2109,1,0.019657187596118893,1.9804333188101555e-05,2110
"('executive', 'action')",2108,1,0.01964786697611125,1.9804333188101555e-05,2109
"('elected', 'i')",2105,1,0.019619905116088323,1.9804333188101555e-05,2106
"('harris', 'if')",2105,1,0.019619905116088323,1.9804333188101555e-05,2106
"('engine', 'google')",2098,1,0.01955466077603482,1.9804333188101555e-05,2099
"('eight', 'times')",2083,1,0.01941485147592018,1.9804333188101555e-05,2084
"('times', 'already')",2078,1,0.019368248375881962,1.9804333188101555e-05,2079
"('deported', 'eight')",2078,1,0.019368248375881962,1.9804333188101555e-05,2079
"('search', 'results')",2038,1,0.018995423575576247,1.9804333188101555e-05,2039
"('google', 'search')",2036,1,0.018976782335560962,1.9804333188101555e-05,2037
"('study', 'the')",2024,1,0.018864934895469247,1.9804333188101555e-05,2025
"('media', 'is')",1929,4,0.01797947599474317,7.921733275240622e-05,1933
"('is', 'duckduckgo')",1925,1,0.017942193514712598,1.9804333188101555e-05,1926
"('duckduckgo', 'better')",1924,1,0.017932872894704955,1.9804333188101555e-05,1925
"('kamala', 'harris')",1853,45,0.01727110887416231,0.00089119499346457,1898
"('of', 'all')",1735,149,0.016171275713260446,0.002950845645027132,1884
"('this', 'one')",1776,41,0.016553421133573807,0.0008119776607121638,1817
"('tom', 'brady')",1784,1,0.016627986093634948,1.9804333188101555e-05,1785
"('the', 'least')",1728,1,0.016106031373206944,1.9804333188101555e-05,1729
"('least', 'of')",1725,1,0.016078069513184017,1.9804333188101555e-05,1726
"('means', 'the')",1725,1,0.016078069513184017,1.9804333188101555e-05,1726
"('says', 'tom')",1724,1,0.016068748893176374,1.9804333188101555e-05,1725
"('‘', 'this')",1724,1,0.016068748893176374,1.9804333188101555e-05,1725
"('brady', 'accepting')",1724,1,0.016068748893176374,1.9804333188101555e-05,1725
"('accepting', 'super')",1724,1,0.016068748893176374,1.9804333188101555e-05,1725
"('all', 'says')",1724,1,0.016068748893176374,1.9804333188101555e-05,1725
"('bowl', 'trophy')",1724,1,0.016068748893176374,1.9804333188101555e-05,1725
"('one', 'means')",1724,1,0.016068748893176374,1.9804333188101555e-05,1725
"('out', 'of')",1429,288,0.013319165990921715,0.005703647958173248,1717
"('to', '‘')",1711,4,0.015947580833077016,7.921733275240622e-05,1715
"('admits', 'hes')",1624,55,0.015136686892412083,0.0010892383253455855,1679
"('illegal', 'aliens')",1666,1,0.015528152932733085,1.9804333188101555e-05,1667
"('is', 'a')",370,1282,0.003448629402827876,0.025389155147146195,1652
"('fascist', 'kamala')",1649,1,0.015369702392603156,1.9804333188101555e-05,1650
"('a', 'reporter')",1629,2,0.015183289992450298,3.960866637620311e-05,1631
"('a', 'serious')",1617,12,0.015071442552358583,0.0002376519982572187,1629
"('acosta', 'admits')",1614,1,0.015043480692335654,1.9804333188101555e-05,1615
"('reporter', 'hes')",1614,1,0.015043480692335654,1.9804333188101555e-05,1615
"('serious', 'author')",1614,1,0.015043480692335654,1.9804333188101555e-05,1615
"('author', 'either')",1614,1,0.015043480692335654,1.9804333188101555e-05,1615
"('not', 'sure')",327,1274,0.003047842742499231,0.025230720481641385,1601
"('to', 'the')",452,1110,0.004212920243454594,0.02198280983879273,1562
"('to', 'be')",398,1152,0.0037096067630418774,0.022814591832692993,1550
"('trump', 'is')",378,1159,0.0035231943628890195,0.022953222165009703,1537
"('jessye', 'norman')",1,1495,9.320620007642909e-06,0.029607478116211828,1496
"('american', 'dad')",1483,1,0.013822479471334434,1.9804333188101555e-05,1484
"('at', '74')",1,1458,9.320620007642909e-06,0.02887471778825207,1459
"('regal', 'american')",1,1456,9.320620007642909e-06,0.028835109121875868,1457
"('american', 'soprano')",1,1456,9.320620007642909e-06,0.028835109121875868,1457
"('died', 'at')",1,1452,9.320620007642909e-06,0.02875589178912346,1453
"('has', 'died')",1,1452,9.320620007642909e-06,0.02875589178912346,1453
"('brought', 'a')",1,1451,9.320620007642909e-06,0.02873608745593536,1452
"('a', 'shimmering')",1,1450,9.320620007642909e-06,0.028716283122747256,1451
"('a', 'br')",1,1450,9.320620007642909e-06,0.028716283122747256,1451
"('74', 'the')",1,1450,9.320620007642909e-06,0.028716283122747256,1451
"('the', 'multiple')",1,1450,9.320620007642909e-06,0.028716283122747256,1451
"('multiple', 'grammy')",1,1450,9.320620007642909e-06,0.028716283122747256,1451
"('grammy', 'award')",1,1450,9.320620007642909e-06,0.028716283122747256,1451
"('norman', 'the')",1,1450,9.320620007642909e-06,0.028716283122747256,1451
"('award', 'winner')",1,1450,9.320620007642909e-06,0.028716283122747256,1451
"('the', 'regal')",1,1450,9.320620007642909e-06,0.028716283122747256,1451
"('winner', 'brought')",1,1450,9.320620007642909e-06,0.028716283122747256,1451
"('soprano', 'has')",1,1450,9.320620007642909e-06,0.028716283122747256,1451
"('shimmering', 'voice')",1,1450,9.320620007642909e-06,0.028716283122747256,1451
"('voice', 'to')",1,1450,9.320620007642909e-06,0.028716283122747256,1451
"('to', 'move')",1425,7,0.013281883510891145,0.0001386303323167109,1432
"('white', 'house')",86,1339,0.0008015733206572901,0.026518002138867985,1425
"('‘', 'american')",1423,1,0.013263242270875858,1.9804333188101555e-05,1424
"('in', 'la')",1407,9,0.013114112350753573,0.000178238998692914,1416
"('over', 'to')",1407,1,0.013114112350753573,1.9804333188101555e-05,1408
"('switched', 'over')",1404,1,0.013086150490730643,1.9804333188101555e-05,1405
"('la', 'bar')",1403,1,0.013076829870723,1.9804333188101555e-05,1404
"('rerun', 'without')",1403,1,0.013076829870723,1.9804333188101555e-05,1404
"('dad', 'rerun')",1403,1,0.013076829870723,1.9804333188101555e-05,1404
"('bar', 'switched')",1403,1,0.013076829870723,1.9804333188101555e-05,1404
"('tv', 'in')",1403,1,0.013076829870723,1.9804333188101555e-05,1404
"('without', 'complaint')",1402,1,0.013067509250715358,1.9804333188101555e-05,1403
"('by', 'this')",7,1317,6.524434005350036e-05,0.02608230680872975,1324
"('president', 'was')",1265,49,0.011790584309668279,0.0009704123262169763,1314
"('poverty', 'and')",1,1305,9.320620007642909e-06,0.02584465481047253,1306
"('the', 'trump')",10,1290,9.320620007642909e-05,0.025547589812651008,1300
"('in', 'latest')",1233,58,0.011492324469423706,0.0011486513249098903,1291
"('allowed', 'to')",19,1272,0.00017709178014521526,0.02519111181526518,1291
"('willing', 'to')",1257,32,0.011716019349607136,0.0006337386620192498,1289
"('to', 'get')",960,324,0.008947795207337192,0.006416603952944904,1284
"('that', 'the')",59,1223,0.0005499165804509316,0.024220699489048203,1282
"('bryce', 'harper')",1272,1,0.011855828649721779,1.9804333188101555e-05,1273
"('been', 'allowed')",5,1264,4.660310003821454e-05,0.025032677149760367,1269
"('was', 'behind')",1266,2,0.011799904929675921,3.960866637620311e-05,1268
"('promotion', 'to')",1265,1,0.011790584309668279,1.9804333188101555e-05,1266
"('to', '4')",1265,1,0.011790584309668279,1.9804333188101555e-05,1266
"('4', 'star')",1265,1,0.011790584309668279,1.9804333188101555e-05,1266
"('they', 'fled')",2,1264,1.8641240015285817e-05,0.025032677149760367,1266
"('denies', 'president')",1265,1,0.011790584309668279,1.9804333188101555e-05,1266
"('administration', 'denies')",1265,1,0.011790584309668279,1.9804333188101555e-05,1266
"('kushners', 'promotion')",1265,1,0.011790584309668279,1.9804333188101555e-05,1266
"('jared', 'kushners')",1265,1,0.011790584309668279,1.9804333188101555e-05,1266
"('behind', 'jared')",1265,1,0.011790584309668279,1.9804333188101555e-05,1266
"('my', 'grandparents')",1,1264,9.320620007642909e-06,0.025032677149760367,1265
"('grandparents', 'wouldve')",1,1264,9.320620007642909e-06,0.025032677149760367,1265
"('enter', 'by')",1,1264,9.320620007642909e-06,0.025032677149760367,1265
"('became', 'bricklayers')",1,1264,9.320620007642909e-06,0.025032677149760367,1265
"('and', 'became')",1,1264,9.320620007642909e-06,0.025032677149760367,1265
"('wouldve', 'been')",1,1264,9.320620007642909e-06,0.025032677149760367,1265
"('fled', 'poverty')",1,1264,9.320620007642909e-06,0.025032677149760367,1265
"('bricklayers', 'and')",1,1264,9.320620007642909e-06,0.025032677149760367,1265
"('sure', 'my')",1,1264,9.320620007642909e-06,0.025032677149760367,1265
"('measure', 'they')",1,1264,9.320620007642909e-06,0.025032677149760367,1265
"('this', 'measure')",1,1264,9.320620007642909e-06,0.025032677149760367,1265
"('star', 'general')",1261,1,0.011753301829637708,1.9804333188101555e-05,1262
"('move', 'to')",1243,12,0.011585530669500134,0.0002376519982572187,1255
"('to', 'another')",1239,1,0.011548248189469564,1.9804333188101555e-05,1240
"('another', 'city')",1238,1,0.011538927569461921,1.9804333188101555e-05,1239
"('asks', 'if')",1238,1,0.011538927569461921,1.9804333188101555e-05,1239
"('harper', 'asks')",1237,1,0.011529606949454277,1.9804333188101555e-05,1238
"('are', 'you')",1111,126,0.010355208828491272,0.002495345981700796,1237
"('if', 'phillies')",1230,1,0.011464362609400777,1.9804333188101555e-05,1231
"('phillies', 'willing')",1228,1,0.011445721369385492,1.9804333188101555e-05,1229
"('coming', 'to')",36,1184,0.0003355423202751447,0.023448330494712243,1220
"('climate', 'change')",1149,62,0.010709392388781701,0.0012278686576622966,1211
"('latest', 'mass')",1188,3,0.011072896569079775,5.941299956430467e-05,1191
"('wielding', 'high')",1188,1,0.011072896569079775,1.9804333188101555e-05,1189
"('freedoms', 'down')",1188,1,0.011072896569079775,1.9804333188101555e-05,1189
"('down', '16')",1188,1,0.011072896569079775,1.9804333188101555e-05,1189
"('16', 'classmates')",1188,1,0.011072896569079775,1.9804333188101555e-05,1189
"('classmates', 'in')",1188,1,0.011072896569079775,1.9804333188101555e-05,1189
"('mass', 'freedoming')",1188,1,0.011072896569079775,1.9804333188101555e-05,1189
"('democrat', 'party')",1186,3,0.01105425532906449,5.941299956430467e-05,1189
"('high', 'schooler')",1188,1,0.011072896569079775,1.9804333188101555e-05,1189
"('schooler', 'freedoms')",1188,1,0.011072896569079775,1.9804333188101555e-05,1189
"('freedom', 'wielding')",1187,1,0.011063575949072132,1.9804333188101555e-05,1188
"('looks', 'like')",889,298,0.008286031186794546,0.005901691290054264,1187
"('not', 'one')",1176,6,0.01096104912898806,0.00011882599912860934,1182
"('an', 'end')",83,1092,0.0007736114606343614,0.0216263318414069,1175
"('one', 'cent')",1171,1,0.010914446028949846,1.9804333188101555e-05,1172
"('to', 'an')",2,1170,1.8641240015285817e-05,0.02317106983007882,1172
"('the', 'democrat')",1163,4,0.010839881068888703,7.921733275240622e-05,1167
"('with', 'the')",797,358,0.007428534146091398,0.007089951281340357,1155
"('last', 'ditch')",1064,90,0.009917139688132055,0.00178238998692914,1154
"('bidens', 'campaign')",1,1144,9.320620007642909e-06,0.02265615716718818,1145
"('projected', 'to')",1142,1,0.010644148048728201,1.9804333188101555e-05,1143
"('want', 'to')",976,164,0.00909692512745948,0.003247910642848655,1140
"('who', 'was')",740,399,0.006897258805655752,0.007901928942052522,1139
"('likely', 'coming')",1,1138,9.320620007642909e-06,0.02253733116805957,1139
"('campaign', 'likely')",1,1132,9.320620007642909e-06,0.02241850516893096,1133
"('wing', 'of')",1124,1,0.010476376888590629,1.9804333188101555e-05,1125
"('hamas', 'wing')",1123,1,0.010467056268582986,1.9804333188101555e-05,1124
"('the', 'president')",11,1111,0.000102526820084072,0.02200261417198083,1122
"('rabid', 'bigot')",1121,1,0.010448415028567701,1.9804333188101555e-05,1122
"('party', 'defends')",1120,1,0.010439094408560057,1.9804333188101555e-05,1121
"('defends', 'rabid')",1120,1,0.010439094408560057,1.9804333188101555e-05,1121
"('bigot', 'omar')",1119,1,0.010429773788552414,1.9804333188101555e-05,1120
"('like', 'a')",953,146,0.008882550867283692,0.002891432645462827,1099
"('thanks', 'to')",12,1078,0.0001118474400917149,0.02134907117677348,1090
"('end', 'thanks')",1,1073,9.320620007642909e-06,0.02125004951083297,1074
"('when', 'you')",944,128,0.008798665287214905,0.002534954648076999,1072
"('change', 'report')",1062,9,0.009898498448116768,0.000178238998692914,1071
"('oil', 'executives')",1063,1,0.009907819068124412,1.9804333188101555e-05,1064
"('of', 'weapons')",1063,1,0.009907819068124412,1.9804333188101555e-05,1064
"('of', 'oil')",1063,1,0.009907819068124412,1.9804333188101555e-05,1064
"('whereabouts', 'of')",1063,1,0.009907819068124412,1.9804333188101555e-05,1064
"('current', 'whereabouts')",1063,1,0.009907819068124412,1.9804333188101555e-05,1064
"('weapons', 'current')",1063,1,0.009907819068124412,1.9804333188101555e-05,1064
"('locations', 'of')",1063,1,0.009907819068124412,1.9804333188101555e-05,1064
"('provides', 'locations')",1063,1,0.009907819068124412,1.9804333188101555e-05,1064
"('report', 'provides')",1063,1,0.009907819068124412,1.9804333188101555e-05,1064
"('ditch', 'climate')",1062,1,0.009898498448116768,1.9804333188101555e-05,1063
"('you', 'are')",847,213,0.007894565146473543,0.004218322969065632,1060
"('excuse', 'for')",677,364,0.006310059745174249,0.007208777280468967,1041
"('from', 'the')",250,787,0.002330155001910727,0.015586010219035926,1037
"('back', 'to')",969,67,0.009031680787405977,0.0013268903236028043,1036
"('clinton', 'linked')",1,1032,9.320620007642909e-06,0.020438071850120806,1033
"('to', 'clinton')",1,1023,9.320620007642909e-06,0.020259832851427892,1024
"('at', 'the')",136,877,0.0012676043210394356,0.017368400205965064,1013
"('new', 'deal')",986,18,0.009190131327535907,0.000356477997385828,1004
"('was', 'a')",739,254,0.006887938185648109,0.005030300629777796,993
"('the', 'whistleblower')",1,990,9.320620007642909e-06,0.01960628985622054,991
"('he', 'had')",877,109,0.008174183746702831,0.0021586723175030698,986
"('this', 'year')",946,39,0.00881730652723019,0.0007723689943359607,985
"('in', 'a')",676,299,0.006300739125166606,0.005921495623242365,975
"('accused', 'of')",933,38,0.008696138467130833,0.0007525646611478592,971
"('for', 'the')",287,683,0.0026750179421935146,0.013526359567473363,970
"('for', 'a')",229,731,0.002134421981750226,0.014476967560502239,960
"('and', 'the')",541,418,0.005042455424134814,0.008278211272626452,959
"('to', 'do')",201,755,0.0018734446215362245,0.014952271557016675,956
"('trying', 'to')",723,230,0.0067388082655258225,0.004554996633263358,953
"('linked', 'ukraine')",1,943,9.320620007642909e-06,0.018675486196379768,944
"('green', 'new')",922,18,0.008593611647046761,0.000356477997385828,940
"('project', 'veritas')",932,1,0.00868681784712319,1.9804333188101555e-05,933
"('ukraine', 'bombshell')",1,932,9.320620007642909e-06,0.01845763853131065,933
"('and', 'i')",292,639,0.0027216210422317294,0.012654968907196895,931
"('president', 'trump')",368,561,0.0034299881628125904,0.011110230918524974,929
"('going', 'to')",543,380,0.0050610966641501,0.007525646611478591,923
"('had', 'to')",883,40,0.008230107466748689,0.0007921733275240623,923
"('why', 'are')",909,12,0.008472443586947404,0.0002376519982572187,921
"('buying', 'votes')",912,1,0.008500405446970333,1.9804333188101555e-05,913
"('literally', 'buying')",911,1,0.008491084826962689,1.9804333188101555e-05,912
"('votes', 'democratvoterfraud')",910,1,0.008481764206955046,1.9804333188101555e-05,911
"('needs', 'to')",89,822,0.0008295351806802189,0.01627916188061948,911
"('man', 'who')",890,18,0.008295351806802189,0.000356477997385828,908
"('to', 'hell')",902,1,0.008407199246893904,1.9804333188101555e-05,903
"('giant', 'demonic')",900,1,0.008388558006878618,1.9804333188101555e-05,901
"('demonic', 'hand')",900,1,0.008388558006878618,1.9804333188101555e-05,901
"('hand', 'bursts')",900,1,0.008388558006878618,1.9804333188101555e-05,901
"('bursts', 'out')",900,1,0.008388558006878618,1.9804333188101555e-05,901
"('bill', 'belichick')",900,1,0.008388558006878618,1.9804333188101555e-05,901
"('of', 'ground')",900,1,0.008388558006878618,1.9804333188101555e-05,901
"('drags', 'bill')",900,1,0.008388558006878618,1.9804333188101555e-05,901
"('belichick', 'back')",900,1,0.008388558006878618,1.9804333188101555e-05,901
"('ground', 'drags')",900,1,0.008388558006878618,1.9804333188101555e-05,901
"('the', 'us')",532,358,0.0049585698440660275,0.007089951281340357,890
"('by', 'a')",561,322,0.005228867824287672,0.006376995286568701,883
"('for', 'work')",874,6,0.008146221886679902,0.00011882599912860934,880
"('is', 'the')",295,584,0.002749582902254658,0.011565730581851308,879
"('party', 'for')",874,2,0.008146221886679902,3.960866637620311e-05,876
"('friends', 'super')",874,1,0.008146221886679902,1.9804333188101555e-05,875
"('bowl', 'party')",874,1,0.008146221886679902,1.9804333188101555e-05,875
"('miss', 'friends')",874,1,0.008146221886679902,1.9804333188101555e-05,875
"('bombshell', 'nunes')",1,874,9.320620007642909e-06,0.01730898720640076,875
"('goff', 'pissed')",874,1,0.008146221886679902,1.9804333188101555e-05,875
"('pissed', 'he')",874,1,0.008146221886679902,1.9804333188101555e-05,875
"('jared', 'goff')",874,1,0.008146221886679902,1.9804333188101555e-05,875
"('it', 'from')",867,6,0.008080977546626402,0.00011882599912860934,873
"('a', 'million')",870,2,0.00810893940664933,3.960866637620311e-05,872
"('so', 'called')",781,90,0.007279404225969111,0.00178238998692914,871
"('jussie', 'smollett')",868,1,0.008090298166634044,1.9804333188101555e-05,869
"('the', 'so')",777,90,0.00724212174593854,0.00178238998692914,867
"('nunes', 'says')",1,865,9.320620007642909e-06,0.017130748207707845,866
"('half', 'a')",862,2,0.008034374446588187,3.960866637620311e-05,864
"('to', 'pay')",845,19,0.007875923906458257,0.0003762823305739296,864
"('enter', 'us')",858,2,0.007997091966557615,3.960866637620311e-05,860
"('us', 'this')",858,2,0.007997091966557615,3.960866637620311e-05,860
"('from', 'happening')",859,1,0.008006412586565259,1.9804333188101555e-05,860
"('million', 'illegal')",858,1,0.007997091966557615,1.9804333188101555e-05,859
"('aliens', 'projected')",858,1,0.007997091966557615,1.9804333188101555e-05,859
"('potentially', 'half')",856,1,0.00797845072654233,1.9804333188101555e-05,857
"('the', 'krassensteins')",853,1,0.007950488866519402,1.9804333188101555e-05,854
"('a', 'ban')",848,5,0.007903885766481187,9.902166594050779e-05,853
"('deactivation', 'not')",851,1,0.007931847626504115,1.9804333188101555e-05,852
"('from', 'twitter')",848,1,0.007903885766481187,1.9804333188101555e-05,849
"('twitter', 'looks')",848,1,0.007903885766481187,1.9804333188101555e-05,849
"('krassensteins', 'have')",848,1,0.007903885766481187,1.9804333188101555e-05,849
"('disappeared', 'from')",848,1,0.007903885766481187,1.9804333188101555e-05,849
"('have', 'disappeared')",848,1,0.007903885766481187,1.9804333188101555e-05,849
"('a', 'deactivation')",848,1,0.007903885766481187,1.9804333188101555e-05,849
"('trump', 'admin')",76,766,0.000708367120580861,0.015170119222085792,842
"('do', 'we')",825,17,0.007689511506305399,0.00033667366419772645,842
"('able', 'to')",817,20,0.0076149465462442565,0.00039608666376203115,837
"('how', 'do')",824,13,0.0076801908862977565,0.00025745633144532023,837
"('google', 'exec')",812,1,0.007568343446206042,1.9804333188101555e-05,813
"('trumps', 'election')",807,2,0.007521740346167827,3.960866637620311e-05,809
"('prevent', 'it')",808,1,0.00753106096617547,1.9804333188101555e-05,809
"('we', 'prevent')",808,1,0.00753106096617547,1.9804333188101555e-05,809
"('happening', 'again')",807,1,0.007521740346167827,1.9804333188101555e-05,808
"('the', 'top')",6,777,5.592372004585745e-05,0.01538796688715491,783
"('more', 'on')",776,3,0.007232801125930897,5.941299956430467e-05,779
"('time', 'marxism')",776,1,0.007232801125930897,1.9804333188101555e-05,777
"('deal', 'old')",776,1,0.007232801125930897,1.9804333188101555e-05,777
"('called', 'green')",776,1,0.007232801125930897,1.9804333188101555e-05,777
"('old', 'time')",776,1,0.007232801125930897,1.9804333188101555e-05,777
"('the', 'senate')",9,765,8.388558006878618e-05,0.015150314888897691,774
"('using', 'twitter')",770,1,0.00717687740588504,1.9804333188101555e-05,771
"('are', 'suing')",769,1,0.007167556785877396,1.9804333188101555e-05,770
"('a', 'man')",760,9,0.00708367120580861,0.000178238998692914,769
"('legal', 'immigrants')",635,131,0.005918593704853247,0.002594367647641304,766
"('a', 'second')",2,761,1.8641240015285817e-05,0.015071097556145285,763
"('twitter', 'when')",757,1,0.007055709345785682,1.9804333188101555e-05,758
"('suing', 'twitter')",756,1,0.007046388725778039,1.9804333188101555e-05,757
"('you', 'using')",756,1,0.007046388725778039,1.9804333188101555e-05,757
"('trump', 'and')",24,727,0.0002236948801834298,0.014397750227749832,751
"('im', 'sick')",734,8,0.006841335085609895,0.00015843466550481244,742
"('to', 'set')",1,737,9.320620007642909e-06,0.014595793559630848,738
"('world', 'of')",734,3,0.006841335085609895,5.941299956430467e-05,737
"('of', 'very')",725,10,0.0067574495055411085,0.00019804333188101558,735
"('like', 'the')",247,483,0.0023021931418877985,0.009565492929853052,730
"('law', 'by')",5,724,4.660310003821454e-05,0.014338337228185527,729
"('set', 'in')",726,1,0.006766770125548751,1.9804333188101555e-05,727
"('partnership', 'with')",725,2,0.0067574495055411085,3.960866637620311e-05,727
"('how', 'to')",612,115,0.00570421944467746,0.002277498316631679,727
"('announces', 'partnership')",725,1,0.0067574495055411085,1.9804333188101555e-05,726
"('hungry', 'caterpillars')",725,1,0.0067574495055411085,1.9804333188101555e-05,726
"('very', 'hungry')",725,1,0.0067574495055411085,1.9804333188101555e-05,726
"('in', 'world')",725,1,0.0067574495055411085,1.9804333188101555e-05,726
"('game', 'set')",725,1,0.0067574495055411085,1.9804333188101555e-05,726
"('for', 'game')",725,1,0.0067574495055411085,1.9804333188101555e-05,726
"('carle', 'for')",725,1,0.0067574495055411085,1.9804333188101555e-05,726
"('eric', 'carle')",725,1,0.0067574495055411085,1.9804333188101555e-05,726
"('fromsoftware', 'announces')",725,1,0.0067574495055411085,1.9804333188101555e-05,726
"('with', 'eric')",725,1,0.0067574495055411085,1.9804333188101555e-05,726
"('the', 'media')",662,52,0.006170250445059605,0.001029825325781281,714
"('should', 'be')",352,358,0.003280858242690304,0.007089951281340357,710
"('the', 'blame')",697,1,0.006496472145327107,1.9804333188101555e-05,698
"('the', 'steele')",677,14,0.006310059745174249,0.0002772606646334218,691
"('blame', 'the')",679,7,0.006328700985189535,0.0001386303323167109,686
"('that', 'he')",27,659,0.0002516567402063585,0.013051055570958927,686
"('of', 'staff')",227,453,0.0021157807417349402,0.008971362934210005,680
"('the', 'consultant')",677,1,0.006310059745174249,1.9804333188101555e-05,678
"('pooch', 'with')",677,1,0.006310059745174249,1.9804333188101555e-05,678
"('consultant', 'excuse')",677,1,0.006310059745174249,1.9804333188101555e-05,678
"('steele', 'dossier')",677,1,0.006310059745174249,1.9804333188101555e-05,678
"('for', 'screwing')",677,1,0.006310059745174249,1.9804333188101555e-05,678
"('screwing', 'the')",677,1,0.006310059745174249,1.9804333188101555e-05,678
"('prepares', 'the')",677,1,0.006310059745174249,1.9804333188101555e-05,678
"('the', 'pooch')",677,1,0.006310059745174249,1.9804333188101555e-05,678
"('exec', 'decries')",676,1,0.006300739125166606,1.9804333188101555e-05,677
"('decries', 'trumps')",676,1,0.006300739125166606,1.9804333188101555e-05,677
"('the', 'world')",540,137,0.005033134804127171,0.0027131936467699133,677
"('authority', 'to')",1,674,9.320620007642909e-06,0.01334812056878045,675
"('californias', 'authority')",1,674,9.320620007642909e-06,0.01334812056878045,675
"('it', 'was')",262,406,0.002442002442002442,0.008040559274369231,668
"('dossier', '”')",666,1,0.006207532925090177,1.9804333188101555e-05,667
"('turn', 'on')",648,19,0.006039761764952605,0.0003762823305739296,667
"('excellent', 'piece')",666,1,0.006207532925090177,1.9804333188101555e-05,667
"('piece', '👇🏻cia')",666,1,0.006207532925090177,1.9804333188101555e-05,667
"('👇🏻cia', 'prepares')",666,1,0.006207532925090177,1.9804333188101555e-05,667
"('bradley', 'cooper')",663,1,0.0061795710650672485,1.9804333188101555e-05,664
"('that', 'this')",651,11,0.006067723624975534,0.00021784766506911712,662
"('i', 'dont')",439,222,0.004091752183355237,0.004396561967758545,661
"('of', 'a')",250,410,0.002330155001910727,0.008119776607121638,660
"('revokes', 'californias')",1,658,9.320620007642909e-06,0.013031251237770825,659
"('on', 'israel')",655,1,0.006105006105006105,1.9804333188101555e-05,656
"('top', 'democrats')",648,3,0.006039761764952605,5.941299956430467e-05,651
"('no', 'one')",590,60,0.005499165804509316,0.0011882599912860935,650
"('democrats', 'turn')",648,1,0.006039761764952605,1.9804333188101555e-05,649
"('set', 'auto')",1,647,9.320620007642909e-06,0.012813403572701706,648
"('auto', 'mileage')",1,646,9.320620007642909e-06,0.012793599239513606,647
"('as', 'the')",34,612,0.0003169010802598589,0.012120251911118153,646
"('administration', 'revokes')",1,644,9.320620007642909e-06,0.012753990573137402,645
"('illegal', 'immigration')",556,88,0.005182264724249457,0.001742781320552937,644
"('state', 'department')",1,642,9.320620007642909e-06,0.0127143819067612,643
"('sick', 'of')",604,35,0.005629654484616316,0.0006931516615835545,639
"('act', 'of')",551,83,0.005135661624211242,0.0016437596546124292,634
"('the', 'law')",52,576,0.00048467224039743125,0.011407295916346497,628
"('fox', 'news')",39,587,0.0003635041802980734,0.011625143581415615,626
"('his', 'own')",31,588,0.00028893922023693014,0.011644947914603715,619
"('mitch', 'mcconnell')",1,611,9.320620007642909e-06,0.012100447577930051,612
"('he', 'was')",256,354,0.0023860787219565846,0.007010733948587951,610
"('the', 'mainstream')",202,407,0.0018827652415438676,0.008060363607557334,609
"('there', 'was')",363,245,0.0033833850627743756,0.004852061631084882,608
"('this', 'doesnt')",605,3,0.00563897510462396,5.941299956430467e-05,608
"('bernie', 'sanders')",501,105,0.004669630623829097,0.0020794549847506635,606
"('election', 'meddling')",600,5,0.005592372004585745,9.902166594050779e-05,605
"('with', 'a')",47,557,0.0004380691403592167,0.011031013585772567,604
"('in', 'ukraine')",1,599,9.320620007642909e-06,0.011862795579672833,600
"('media', 'pretending')",598,1,0.005573730764570459,1.9804333188101555e-05,599
"('meddling', 'im')",597,1,0.005564410144562816,1.9804333188101555e-05,598
"('censorship', 'is')",597,1,0.005564410144562816,1.9804333188101555e-05,598
"('is', 'election')",597,1,0.005564410144562816,1.9804333188101555e-05,598
"('pretending', 'that')",597,1,0.005564410144562816,1.9804333188101555e-05,598
"('algorythmic', 'censorship')",597,1,0.005564410144562816,1.9804333188101555e-05,598
"('doesnt', 'exist')",597,1,0.005564410144562816,1.9804333188101555e-05,598
"('100', 'of')",597,1,0.005564410144562816,1.9804333188101555e-05,598
"('–', 'google')",596,1,0.005555089524555174,1.9804333188101555e-05,597
"('veritas', '–')",596,1,0.005555089524555174,1.9804333188101555e-05,597
"('he', 'has')",13,581,0.00012116806009935781,0.011506317582287004,594
"('time', 'that')",1,591,9.320620007642909e-06,0.01170436091416802,592
"('as', 'a')",380,211,0.003541835602904305,0.004178714302689428,591
"('arrested', 'for')",341,249,0.0031783314226062316,0.004931278963837288,590
"('new', 'york')",149,441,0.0013887723811387934,0.008733710935952786,590
"('list', 'of')",438,149,0.0040824315633475935,0.002950845645027132,587
"('national', 'security')",5,581,4.660310003821454e-05,0.011506317582287004,586
"('the', 'house')",8,576,7.456496006114327e-05,0.011407295916346497,584
"('to', 'kill')",560,20,0.005219547204280028,0.00039608666376203115,580
"('year', 'old')",475,102,0.004427294503630381,0.002020041985186359,577
"('federal', 'judge')",1,573,9.320620007642909e-06,0.011347882916782192,574
"('to', 'ukraine')",1,570,9.320620007642909e-06,0.011288469917217887,571
"('crimes', 'in')",301,270,0.0028055066223005155,0.005347169960787421,571
"('rest', 'of')",539,31,0.0050238141841195275,0.0006139343288311483,570
"('by', 'the')",288,278,0.0026843385622011577,0.005505604626292232,566
"('the', 'time')",25,541,0.00023301550019107272,0.010714144254762942,566
"('on', 'freedom')",565,1,0.005266150304318243,1.9804333188101555e-05,566
"('requests', 'to')",559,6,0.005210226584272386,0.00011882599912860934,565
"('a', 'young')",561,3,0.005228867824287672,5.941299956430467e-05,564
"('‘', 'how')",563,1,0.005247509064302957,1.9804333188101555e-05,564
"('election', '‘')",562,1,0.0052381884442953145,1.9804333188101555e-05,563
"('to', 'make')",244,319,0.00227423128186487,0.006317582287004396,563
"('to', 'sample')",560,1,0.005219547204280028,1.9804333188101555e-05,561
"('sample', 'royal')",559,1,0.005210226584272386,1.9804333188101555e-05,560
"('queen', 'elizabeth')",559,1,0.005210226584272386,1.9804333188101555e-05,560
"('royal', 'baby')",559,1,0.005210226584272386,1.9804333188101555e-05,560
"('millers', 'requests')",559,1,0.005210226584272386,1.9804333188101555e-05,560
"('stephen', 'millers')",559,1,0.005210226584272386,1.9804333188101555e-05,560
"('by', 'stephen')",559,1,0.005210226584272386,1.9804333188101555e-05,560
"('unnerved', 'by')",559,1,0.005210226584272386,1.9804333188101555e-05,560
"('elizabeth', 'unnerved')",559,1,0.005210226584272386,1.9804333188101555e-05,560
"('you', 'know')",514,42,0.004790798683928455,0.0008317819939002653,556
"('hands', 'on')",552,1,0.005144982244218886,1.9804333188101555e-05,553
"('for', 'it')",513,39,0.004781478063920812,0.0007723689943359607,552
"('get', 'his')",549,3,0.005117020384195957,5.941299956430467e-05,552
"('of', 'foreign')",1,550,9.320620007642909e-06,0.010892383253455856,551
"('perpetrated', 'by')",548,2,0.005107699764188314,3.960866637620311e-05,550
"('young', 'man')",549,1,0.005117020384195957,1.9804333188101555e-05,550
"('without', 'goin')",548,1,0.005107699764188314,1.9804333188101555e-05,549
"('is', 'an')",77,472,0.000717687740588504,0.009347645264783934,549
"('senseless', 'act')",548,1,0.005107699764188314,1.9804333188101555e-05,549
"('a', 'senseless')",548,1,0.005107699764188314,1.9804333188101555e-05,549
"('tragedy', 'was')",548,1,0.005107699764188314,1.9804333188101555e-05,549
"('this', 'tragedy')",548,1,0.005107699764188314,1.9804333188101555e-05,549
"('was', 'able')",548,1,0.005107699764188314,1.9804333188101555e-05,549
"('freedom', 'without')",548,1,0.005107699764188314,1.9804333188101555e-05,549
"('his', 'hands')",548,1,0.005107699764188314,1.9804333188101555e-05,549
"('freedom', 'perpetrated')",548,1,0.005107699764188314,1.9804333188101555e-05,549
"('of', 'freedom')",548,1,0.005107699764188314,1.9804333188101555e-05,549
"('has', 'already')",5,543,4.660310003821454e-05,0.010753752921139146,548
"('its', 'not')",39,507,0.0003635041802980734,0.010040796926367489,546
"('the', 'son')",30,516,0.00027961860022928726,0.010219035925060403,546
"('breaking', 'via')",1,544,9.320620007642909e-06,0.010773557254327246,545
"('via', 'nyt')",1,544,9.320620007642909e-06,0.010773557254327246,545
"('to', 'see')",455,89,0.004240882103477523,0.0017625856537410386,544
"('to', 'vote')",528,14,0.004921287364035455,0.0002772606646334218,542
"('a', 'federal')",4,531,3.7282480030571634e-05,0.010516100922881926,535
"('i', 'think')",54,479,0.000503313480412717,0.009486275597100646,533
"('failing', 'to')",1,532,9.320620007642909e-06,0.010535905256070028,533
"('against', 'trump')",473,60,0.004408653263615095,0.0011882599912860935,533
"('to', 'put')",505,27,0.004706913103859668,0.000534716996078742,532
"('since', 'he')",5,522,4.660310003821454e-05,0.010337861924189012,527
"('for', 'afghans')",1,526,9.320620007642909e-06,0.010417079256941419,527
"('by', 'failing')",1,525,9.320620007642909e-06,0.010397274923753317,526
"('who', 'served')",3,521,2.7961860022928726e-05,0.010318057591000912,524
"('to', 'investigate')",54,469,0.000503313480412717,0.00928823226521963,523
"('predicts', 'patriots')",522,1,0.004865363643989598,1.9804333188101555e-05,523
"('outcome', 'rest')",522,1,0.004865363643989598,1.9804333188101555e-05,523
"('patriots', 'pass')",522,1,0.004865363643989598,1.9804333188101555e-05,523
"('of', 'julian')",522,1,0.004865363643989598,1.9804333188101555e-05,523
"('accurately', 'predicts')",522,1,0.004865363643989598,1.9804333188101555e-05,523
"('pass', 'play')",522,1,0.004865363643989598,1.9804333188101555e-05,523
"('play', 'games')",522,1,0.004865363643989598,1.9804333188101555e-05,523
"('romo', 'accurately')",522,1,0.004865363643989598,1.9804333188101555e-05,523
"('tony', 'romo')",522,1,0.004865363643989598,1.9804333188101555e-05,523
"('games', 'outcome')",522,1,0.004865363643989598,1.9804333188101555e-05,523
"('i', 'agree')",7,516,6.524434005350036e-05,0.010219035925060403,523
"('julian', 'edelmans')",522,1,0.004865363643989598,1.9804333188101555e-05,523
"('applications', 'for')",1,521,9.320620007642909e-06,0.010318057591000912,522
"('edelmans', 'life')",521,1,0.004856043023981955,1.9804333188101555e-05,522
"('it', 'is')",158,364,0.0014726579612075795,0.007208777280468967,522
"('foreign', 'service')",1,520,9.320620007642909e-06,0.01029825325781281,521
"('violated', 'the')",1,520,9.320620007642909e-06,0.01029825325781281,521
"('judge', 'has')",1,520,9.320620007642909e-06,0.01029825325781281,521
"('to', 'resolve')",1,519,9.320620007642909e-06,0.010278448924624707,520
"('visa', 'applications')",1,519,9.320620007642909e-06,0.010278448924624707,520
"('to', 'tell')",466,54,0.004343408923561595,0.001069433992157484,520
"('admin', 'violated')",1,519,9.320620007642909e-06,0.010278448924624707,520
"('found', 'that')",1,519,9.320620007642909e-06,0.010278448924624707,520
"('resolve', 'visa')",1,519,9.320620007642909e-06,0.010278448924624707,520
"('has', 'ruled')",1,519,9.320620007642909e-06,0.010278448924624707,520
"('ruled', 'that')",1,519,9.320620007642909e-06,0.010278448924624707,520
"('afghans', 'and')",1,519,9.320620007642909e-06,0.010278448924624707,520
"('be', 'a')",404,114,0.003765530483087735,0.0022576939834435773,518
"('in', 'dangerous')",2,515,1.8641240015285817e-05,0.010199231591872302,517
"('id', 'say')",5,512,4.660310003821454e-05,0.010139818592307996,517
"('served', 'often')",1,515,9.320620007642909e-06,0.010199231591872302,516
"('on', 'a')",345,171,0.0032156139026368034,0.0033865409751653664,516
"('son', 'grandson')",1,515,9.320620007642909e-06,0.010199231591872302,516
"('grandson', 'nephew')",1,515,9.320620007642909e-06,0.010199231591872302,516
"('nephew', 'and')",1,515,9.320620007642909e-06,0.010199231591872302,516
"('and', 'cousin')",1,515,9.320620007642909e-06,0.010199231591872302,516
"('cousin', 'of')",1,515,9.320620007642909e-06,0.010199231591872302,516
"('agree', 'our')",1,515,9.320620007642909e-06,0.010199231591872302,516
"('service', 'officers')",1,515,9.320620007642909e-06,0.010199231591872302,516
"('often', 'in')",1,515,9.320620007642909e-06,0.010199231591872302,516
"('our', 'd')",1,515,9.320620007642909e-06,0.010199231591872302,516
"('officers', 'who')",1,515,9.320620007642909e-06,0.010199231591872302,516
"('posts', 'i')",1,515,9.320620007642909e-06,0.010199231591872302,516
"('dangerous', 'posts')",1,515,9.320620007642909e-06,0.010199231591872302,516
"('has', 'some')",2,513,1.8641240015285817e-05,0.010159622925496098,515
"('some', 'splanin')",1,512,9.320620007642909e-06,0.010139818592307996,513
"('bejing', 'has')",1,512,9.320620007642909e-06,0.010139818592307996,513
"('ole', 'bejing')",1,512,9.320620007642909e-06,0.010139818592307996,513
"('say', 'ole')",1,512,9.320620007642909e-06,0.010139818592307996,513
"('splanin', 'to')",1,512,9.320620007642909e-06,0.010139818592307996,513
"('nbcwsj', 'poll')",1,510,9.320620007642909e-06,0.010100209925931794,511
"('will', 'be')",255,255,0.0023767581019489416,0.005050104962965897,510
"('have', 'a')",170,340,0.0015845054012992945,0.006733473283954529,510
"('if', 'you')",300,209,0.0027961860022928725,0.004139105636313226,509
"('would', 'be')",381,126,0.003551156222911948,0.002495345981700796,507
"('to', 'meet')",4,500,3.7282480030571634e-05,0.009902166594050778,504
"('president', 'trumps')",23,479,0.0002143742601757869,0.009486275597100646,502
"('to', 'have')",179,322,0.0016683909813680806,0.006376995286568701,501
"('senate', 'trial')",1,499,9.320620007642909e-06,0.009882362260862677,500
"('recuse', 'himself')",1,499,9.320620007642909e-06,0.009882362260862677,500
"('to', 'recuse')",1,499,9.320620007642909e-06,0.009882362260862677,500
"('us', 'to')",45,455,0.00041942790034393086,0.009010971600586209,500
"('but', 'the')",9,490,8.388558006878618e-05,0.009704123262169764,499
"('trial', 'since')",1,498,9.320620007642909e-06,0.009862557927674575,499
"('is', 'innoc')",1,498,9.320620007642909e-06,0.009862557927674575,499
"('decided', 'trump')",1,498,9.320620007642909e-06,0.009862557927674575,499
"('already', 'decided')",1,498,9.320620007642909e-06,0.009862557927674575,499
"('himself', 'from')",1,498,9.320620007642909e-06,0.009862557927674575,499
"('mcconnell', 'needs')",1,498,9.320620007642909e-06,0.009862557927674575,499
"('pay', 'for')",479,19,0.0044645769836609535,0.0003762823305739296,498
"('sounds', 'like')",15,478,0.00013980930011464363,0.009466471263912543,493
"('all', 'the')",319,174,0.0029732777824380877,0.003445953974729671,493
"('be', 'impeached')",1,491,9.320620007642909e-06,0.009723927595357864,492
"('beet', 'juice')",490,1,0.004567103803745025,1.9804333188101555e-05,491
"('to', 'stop')",127,363,0.0011837187409706495,0.007188972947280865,490
"('elizabeth', 'warren')",55,432,0.00051263410042036,0.008555471937259872,487
"('fails', 'to')",203,283,0.0018920858615515104,0.00560462629223274,486
"('there', 'is')",335,151,0.0031224077025603742,0.002990454311403335,486
"('to', 'know')",322,163,0.0030012396424610164,0.003228106309660554,485
"('be', 'fired')",443,42,0.004129034663385808,0.0008317819939002653,485
"('rights', 'activists')",481,1,0.004483218223676239,1.9804333188101555e-05,482
"('meat', 'rights')",480,1,0.004473897603668596,1.9804333188101555e-05,481
"('trump', 'has')",8,469,7.456496006114327e-05,0.00928823226521963,477
"('and', 'his')",22,454,0.000205053640168144,0.008991167267398107,476
"('doused', 'with')",474,2,0.004417973883622739,3.960866637620311e-05,476
"('eating', 'impossible')",474,1,0.004417973883622739,1.9804333188101555e-05,475
"('impossible', 'burgers')",474,1,0.004417973883622739,1.9804333188101555e-05,475
"('burgers', 'doused')",474,1,0.004417973883622739,1.9804333188101555e-05,475
"('with', 'beet')",474,1,0.004417973883622739,1.9804333188101555e-05,475
"('protesting', 'meat')",474,1,0.004417973883622739,1.9804333188101555e-05,475
"('juice', 'by')",474,1,0.004417973883622739,1.9804333188101555e-05,475
"('by', 'protesting')",474,1,0.004417973883622739,1.9804333188101555e-05,475
"('diners', 'eating')",471,1,0.00439001202359981,1.9804333188101555e-05,472
"('could', 'be')",404,67,0.003765530483087735,0.0013268903236028043,471
"('allegation', 'against')",466,1,0.004343408923561595,1.9804333188101555e-05,467
"('rape', 'allegation')",466,1,0.004343408923561595,1.9804333188101555e-05,467
"('how', 'many')",382,85,0.003560476842919591,0.0016833683209886323,467
"('up', 'to')",240,226,0.002236948801834298,0.004475779300510952,466
"('not', 'to')",295,171,0.002749582902254658,0.0033865409751653664,466
"('to', 'no')",463,2,0.0043154470635386665,3.960866637620311e-05,465
"('savage', 'rape')",464,1,0.004324767683546309,1.9804333188101555e-05,465
"('could', 'verify')",464,1,0.004324767683546309,1.9804333188101555e-05,465
"('plan', 'to')",338,126,0.003150369562583303,0.002495345981700796,464
"('about', 'the')",89,374,0.0008295351806802189,0.007406820612349982,463
"('sdny', 'epstein')",461,1,0.0042968058235233805,1.9804333188101555e-05,462
"('epstein', 'investigation')",461,1,0.0042968058235233805,1.9804333188101555e-05,462
"('investigation', 'could')",461,1,0.0042968058235233805,1.9804333188101555e-05,462
"('know', 'i')",455,6,0.004240882103477523,0.00011882599912860934,461
"('one', 'in')",453,6,0.004222240863462238,0.00011882599912860934,459
"('diversity', 'visa')",458,1,0.004268843963500452,1.9804333188101555e-05,459
"('trump', 'via')",430,26,0.004007866603286451,0.0005149126628906405,456
"('it', 'too')",453,3,0.004222240863462238,5.941299956430467e-05,456
"('to', 'remove')",444,12,0.004138355283393452,0.0002376519982572187,456
"('that', 'she')",217,238,0.002022574541658511,0.0047134312987681705,455
"('at', 'least')",223,231,0.0020784982617043685,0.004574800966451459,454
"('again', 'to')",451,3,0.004203599623446952,5.941299956430467e-05,454
"('in', 'particular')",452,1,0.004212920243454594,1.9804333188101555e-05,453
"('‘', 'you')",452,1,0.004212920243454594,1.9804333188101555e-05,453
"('verify', 'savage')",451,1,0.004203599623446952,1.9804333188101555e-05,452
"('out', 'loud')",451,1,0.004203599623446952,1.9804333188101555e-05,452
"('loud', 'again')",450,1,0.004194279003439309,1.9804333188101555e-05,451
"('says', 'out')",450,1,0.004194279003439309,1.9804333188101555e-05,451
"('directed', 'it')",450,1,0.004194279003439309,1.9804333188101555e-05,451
"('cooper', 'says')",450,1,0.004194279003439309,1.9804333188101555e-05,451
"('i', 'directed')",450,1,0.004194279003439309,1.9804333188101555e-05,451
"('too', 'bradley')",450,1,0.004194279003439309,1.9804333188101555e-05,451
"('oscars', 'htt')",449,1,0.004184958383431666,1.9804333188101555e-05,450
"('particular', 'oscars')",449,1,0.004184958383431666,1.9804333188101555e-05,450
"('mileage', 'standards')",1,447,9.320620007642909e-06,0.008852536935081395,448
"('come', 'forward')",424,24,0.0039519428832405935,0.0004753039965144374,448
"('the', 'sdny')",444,3,0.004138355283393452,5.941299956430467e-05,447
"('diplomat', 'in')",1,445,9.320620007642909e-06,0.008812928268705193,446
"('days', 'after')",406,39,0.003784171723103021,0.0007723689943359607,445
"('on', '‘')",443,1,0.004129034663385808,1.9804333188101555e-05,444
"('us', 'from')",442,2,0.004119714043378166,3.960866637620311e-05,444
"('in', 'us')",433,11,0.0040358284633093796,0.00021784766506911712,444
"('trumps', 'ukraine')",1,443,9.320620007642909e-06,0.00877331960232899,444
"('joe', 'biden')",257,187,0.0023953993419642276,0.003703410306174991,444
"('kazakhstan', 'on')",442,1,0.004119714043378166,1.9804333188101555e-05,443
"('to', 'help')",68,375,0.0006338021605197178,0.007426624945538083,443
"('you', 'cant')",435,8,0.004054469703324665,0.00015843466550481244,443
"('from', 'kazakhstan')",442,1,0.004119714043378166,1.9804333188101555e-05,443
"('isis', 'sniper')",442,1,0.004119714043378166,1.9804333188101555e-05,443
"('visa', 'lottery')",441,1,0.004110393423370522,1.9804333188101555e-05,442
"('abc', 'news')",1,441,9.320620007642909e-06,0.008733710935952786,442
"('role', 'of')",424,18,0.0039519428832405935,0.000356477997385828,442
"('refuse', 'to')",434,7,0.004045149083317022,0.0001386303323167109,441
"('sniper', 'entered')",439,1,0.004091752183355237,1.9804333188101555e-05,440
"('entered', 'us')",439,1,0.004091752183355237,1.9804333188101555e-05,440
"('alleged', 'isis')",438,1,0.0040824315633475935,1.9804333188101555e-05,439
"('that', 'we')",12,427,0.0001118474400917149,0.008456450271319365,439
"('have', 'been')",142,295,0.001323528041085293,0.00584227829048996,437
"('for', 'asking')",392,44,0.00365368304299602,0.0008713906602764685,436
"('time', 'to')",337,99,0.0031410489425756603,0.0019606289856220543,436
"('that', 'would')",41,395,0.0003821454203133592,0.007822711609300115,436
"('whether', 'to')",1,434,9.320620007642909e-06,0.008595080603636075,435
"('the', 'white')",36,399,0.0003355423202751447,0.007901928942052522,435
"('in', 'nbcwsj')",1,430,9.320620007642909e-06,0.00851586327088367,431
"('nationwide', 'in')",1,430,9.320620007642909e-06,0.00851586327088367,431
"('4', 'nationwide')",1,430,9.320620007642909e-06,0.00851586327088367,431
"('has', 'been')",113,317,0.0010532300608636486,0.006277973620628194,430
"('poll', '👍🇺🇸')",1,428,9.320620007642909e-06,0.008476254604507466,429
"('take', 'over')",428,1,0.003989225363271165,1.9804333188101555e-05,429
"('3', 'piece')",427,1,0.003979904743263522,1.9804333188101555e-05,428
"('piece', 'formal')",427,1,0.003979904743263522,1.9804333188101555e-05,428
"('introduces', 'new')",427,1,0.003979904743263522,1.9804333188101555e-05,428
"('trojan', 'unveils')",426,1,0.003970584123255879,1.9804333188101555e-05,427
"('unveils', 'new')",426,1,0.003970584123255879,1.9804333188101555e-05,427
"('meryl', 'streep')",426,1,0.003970584123255879,1.9804333188101555e-05,427
"('formal', 'condoms')",426,1,0.003970584123255879,1.9804333188101555e-05,427
"('new', '3')",426,1,0.003970584123255879,1.9804333188101555e-05,427
"('streep', 'will')",424,1,0.0039519428832405935,1.9804333188101555e-05,425
"('announces', 'meryl')",424,1,0.0039519428832405935,1.9804333188101555e-05,425
"('jj', 'abrams')",424,1,0.0039519428832405935,1.9804333188101555e-05,425
"('over', 'role')",424,1,0.0039519428832405935,1.9804333188101555e-05,425
"('abrams', 'announces')",424,1,0.0039519428832405935,1.9804333188101555e-05,425
"('to', 'ukraines')",1,424,9.320620007642909e-06,0.00839703727175506,425
"('of', 'chewbacca')",423,1,0.00394262226323295,1.9804333188101555e-05,424
"('on', 'trump')",44,379,0.000410107280336288,0.00750584227829049,423
"('is', 'no')",363,60,0.0033833850627743756,0.0011882599912860935,423
"('is', 'weighing')",1,421,9.320620007642909e-06,0.008337624272190756,422
"('mr', 'trump')",1,418,9.320620007642909e-06,0.008278211272626452,419
"('vice', 'president')",214,202,0.0019946126816355824,0.0040004753039965145,416
"('second', 'whistleblower')",1,415,9.320620007642909e-06,0.008218798273062145,416
"('2016', 'election')",5,410,4.660310003821454e-05,0.008119776607121638,415
"('americans', 'want')",408,6,0.0038028129631183065,0.00011882599912860934,414
"('security', 'adviser')",1,412,9.320620007642909e-06,0.00815938527349784,413
"('whistleblower', 'complaint')",1,411,9.320620007642909e-06,0.00813958094030974,412
"('and', 'make')",409,2,0.0038121335831259495,3.960866637620311e-05,411
"('‘', 'diversity')",410,1,0.0038214542031335926,1.9804333188101555e-05,411
"('else', 'for')",407,3,0.003793492343110664,5.941299956430467e-05,410
"('we', 'were')",16,394,0.00014912992012228654,0.007802907276112013,410
"('we', 'dont')",71,338,0.0006617640205426465,0.006693864617578326,409
"('el', 'chapo')",408,1,0.0038028129631183065,1.9804333188101555e-05,409
"('of', 'this')",164,245,0.001528581681253437,0.004852061631084882,409
"('story', 'first')",1,407,9.320620007642909e-06,0.008060363607557334,408
"('later', 'sounds')",1,407,9.320620007642909e-06,0.008060363607557334,408
"('interesting', 'concept')",1,407,9.320620007642909e-06,0.008060363607557334,408
"('impeach', 'first')",1,407,9.320620007642909e-06,0.008060363607557334,408
"('media', '–')",1,407,9.320620007642909e-06,0.008060363607557334,408
"('facts', 'later')",1,407,9.320620007642909e-06,0.008060363607557334,408
"('first', 'veri')",1,407,9.320620007642909e-06,0.008060363607557334,408
"('–', 'write')",1,407,9.320620007642909e-06,0.008060363607557334,408
"('it', '—gt')",407,1,0.003793492343110664,1.9804333188101555e-05,408
"('first', 'find')",1,407,9.320620007642909e-06,0.008060363607557334,408
"('him', 'out')",5,403,4.660310003821454e-05,0.007981146274804927,408
"('chapo', 'pay')",407,1,0.003793492343110664,1.9804333188101555e-05,408
"('make', 'el')",407,1,0.003793492343110664,1.9804333188101555e-05,408
"('buildthewall', 'and')",407,1,0.003793492343110664,1.9804333188101555e-05,408
"('find', 'facts')",1,407,9.320620007642909e-06,0.008060363607557334,408
"('concept', 'impeach')",1,407,9.320620007642909e-06,0.008060363607557334,408
"('write', 'story')",1,407,9.320620007642909e-06,0.008060363607557334,408
"('clause', 'in')",406,2,0.003784171723103021,3.960866637620311e-05,408
"('from', 'living')",406,1,0.003784171723103021,1.9804333188101555e-05,407
"('tenants', 'from')",406,1,0.003784171723103021,1.9804333188101555e-05,407
"('living', 'anywhere')",406,1,0.003784171723103021,1.9804333188101555e-05,407
"('noncompete', 'clause')",406,1,0.003784171723103021,1.9804333188101555e-05,407
"('bars', 'tenants')",406,1,0.003784171723103021,1.9804333188101555e-05,407
"('90', 'days')",406,1,0.003784171723103021,1.9804333188101555e-05,407
"('moving', 'out')",406,1,0.003784171723103021,1.9804333188101555e-05,407
"('for', '90')",406,1,0.003784171723103021,1.9804333188101555e-05,407
"('after', 'moving')",406,1,0.003784171723103021,1.9804333188101555e-05,407
"('in', 'lease')",406,1,0.003784171723103021,1.9804333188101555e-05,407
"('lease', 'bars')",406,1,0.003784171723103021,1.9804333188101555e-05,407
"('anywhere', 'else')",406,1,0.003784171723103021,1.9804333188101555e-05,407
"('fired', 'for')",405,1,0.003774851103095378,1.9804333188101555e-05,406
"('that', 'none')",1,405,9.320620007642909e-06,0.008020754941181131,406
"('more', 'than')",153,252,0.001426054861169365,0.004990691963401592,405
"('and', 'they')",226,178,0.002106460121727297,0.0035251713074820772,404
"('ocasio', 'cortez')",375,29,0.003495232502866091,0.0005743256624549452,404
"('trump', 'says')",16,384,0.00014912992012228654,0.007604863944230998,400
"('two', 'men')",382,18,0.003560476842919591,0.000356477997385828,400
"('ukraine', 'was')",1,399,9.320620007642909e-06,0.007901928942052522,400
"('will', 'not')",201,198,0.0018734446215362245,0.003921257971244109,399
"('pay', 'more')",392,6,0.00365368304299602,0.00011882599912860934,398
"('more', 'taxes')",392,6,0.00365368304299602,0.00011882599912860934,398
"('in', 'real')",1,396,9.320620007642909e-06,0.007842515942488217,397
"('of', 'trumps')",2,394,1.8641240015285817e-05,0.007802907276112013,396
"('the', 'new')",37,358,0.0003448629402827876,0.007089951281340357,395
"('that', 'isnt')",6,389,5.592372004585745e-05,0.007703885610171506,395
"('he', 'is')",119,276,0.0011091537809095062,0.00546599595991603,395
"('doctor', 'could')",392,1,0.00365368304299602,1.9804333188101555e-05,393
"('real', 'time')",1,392,9.320620007642909e-06,0.0077632986097358105,393
"('asking', 'muslim')",392,1,0.00365368304299602,1.9804333188101555e-05,393
"('muslim', 'woman')",392,1,0.00365368304299602,1.9804333188101555e-05,393
"('woman', 'to')",392,1,0.00365368304299602,1.9804333188101555e-05,393
"('expected', 'to')",343,50,0.0031969726626215177,0.0009902166594050778,393
"('cory', 'booker')",367,25,0.0034206675428049473,0.0004951083297025389,392
"('men', 'to')",390,1,0.0036350418029807343,1.9804333188101555e-05,391
"('trump', 'won')",388,3,0.0036164005629654486,5.941299956430467e-05,391
"('because', 'theyre')",366,24,0.0034113469227973043,0.0004753039965144374,390
"('know', 'the')",314,76,0.0029266746823998734,0.0015051293222957183,390
"('many', 'more')",382,7,0.003560476842919591,0.0001386303323167109,389
"('legal', 'immigration')",276,113,0.002572491122109443,0.002237889650255476,389
"('bombshell', 'that')",1,388,9.320620007642909e-06,0.007684081276983404,389
"('isnt', 'getting')",1,388,9.320620007642909e-06,0.007684081276983404,389
"('getting', 'much')",1,388,9.320620007642909e-06,0.007684081276983404,389
"('much', 'notice')",1,388,9.320620007642909e-06,0.007684081276983404,389
"('notice', 'but')",1,388,9.320620007642909e-06,0.007684081276983404,389
"('top', 'diplomat')",1,388,9.320620007642909e-06,0.007684081276983404,389
"('a', 'bombshell')",1,388,9.320620007642909e-06,0.007684081276983404,389
"('weighing', 'whether')",1,387,9.320620007642909e-06,0.007664276943795303,388
"('was', 'texting')",1,386,9.320620007642909e-06,0.0076444726106072005,387
"('texting', 'in')",1,386,9.320620007642909e-06,0.0076444726106072005,387
"('were', 'wit')",1,386,9.320620007642909e-06,0.0076444726106072005,387
"('going', 'on')",263,123,0.002451323062010085,0.0024359329821364915,386
"('if', 'they')",263,123,0.002451323062010085,0.0024359329821364915,386
"('on', 'trumps')",132,253,0.0012303218410088638,0.0050104962965896935,385
"('dont', 'know')",17,368,0.00015845054012992945,0.007287994613221373,385
"('see', 'how')",379,5,0.003532514982896662,9.902166594050779e-05,384
"('to', 'take')",62,322,0.0005778784404738603,0.006376995286568701,384
"('are', 'we')",369,15,0.0034393087828202334,0.00029706499782152337,384
"('to', 'stage')",382,2,0.003560476842919591,3.960866637620311e-05,384
"('trump', 'in')",236,148,0.0021996663218037263,0.0029310413118390304,384
"('convicted', 'of')",382,1,0.003560476842919591,1.9804333188101555e-05,383
"('in', '2016')",5,378,4.660310003821454e-05,0.007486037945102389,383
"('believe', 'jussie')",381,1,0.003551156222911948,1.9804333188101555e-05,382
"('paid', 'two')",381,1,0.003551156222911948,1.9804333188101555e-05,382
"('smollett', 'paid')",381,1,0.003551156222911948,1.9804333188101555e-05,382
"('of', 'our')",38,344,0.0003541835602904305,0.006812690616706935,382
"('york', 'times')",4,378,3.7282480030571634e-05,0.007486037945102389,382
"('on', 'dems')",364,18,0.0033927056827820186,0.000356477997385828,382
"('stage', 'attack')",380,1,0.003541835602904305,1.9804333188101555e-05,381
"('now', 'you')",378,1,0.0035231943628890195,1.9804333188101555e-05,379
"('5', 'us')",377,1,0.0035138737428813765,1.9804333188101555e-05,378
"('killing', '5')",377,1,0.0035138737428813765,1.9804333188101555e-05,378
"('with', 'killing')",377,1,0.0035138737428813765,1.9804333188101555e-05,378
"('too', 'far')",375,2,0.003495232502866091,3.960866637620311e-05,377
"('attack', 'on')",315,62,0.002935995302407516,0.0012278686576622966,377
"('have', 'gone')",375,2,0.003495232502866091,3.960866637620311e-05,377
"('the', 'ukraine')",1,375,9.320620007642909e-06,0.007426624945538083,376
"('the', 'united')",269,107,0.0025072467820559424,0.0021190636511268664,376
"('gone', 'too')",372,4,0.003467270642843162,7.921733275240622e-05,376
"('calls', 'for')",321,54,0.002991919022453374,0.001069433992157484,375
"('chiefs', 'of')",1,374,9.320620007642909e-06,0.007406820612349982,375
"('an', 'actual')",370,4,0.003448629402827876,7.921733275240622e-05,374
"('man', 'a')",371,2,0.003457950022835519,3.960866637620311e-05,373
"('under', 'trump')",348,25,0.003243575762659732,0.0004951083297025389,373
"('being', 'an')",370,3,0.003448629402827876,5.941299956430467e-05,373
"('are', 'the')",234,139,0.0021810250817884407,0.002752802313146116,373
"('a', 'public')",5,368,4.660310003821454e-05,0.007287994613221373,373
"('united', 'states')",251,121,0.00233947562191837,0.002396324315760288,372
"('call', 'a')",369,3,0.0034393087828202334,5.941299956430467e-05,372
"('you', 'think')",342,30,0.0031876520426138747,0.0005941299956430467,372
"('without', 'it')",370,1,0.003448629402827876,1.9804333188101555e-05,371
"('man', '”')",369,2,0.0034393087828202334,3.960866637620311e-05,371
"('they', 'will')",85,286,0.0007922527006496473,0.005664039291797045,371
"('top', 'us')",1,370,9.320620007642909e-06,0.007327603279597576,371
"('it', 'being')",370,1,0.003448629402827876,1.9804333188101555e-05,371
"('an', 'appalling')",3,367,2.7961860022928726e-05,0.007268190280033272,370
"('actual', 'crime')",369,1,0.0034393087828202334,1.9804333188101555e-05,370
"('cant', 'call')",369,1,0.0034393087828202334,1.9804333188101555e-05,370
"('insane', 'sjw')",369,1,0.0034393087828202334,1.9804333188101555e-05,370
"('far', 'now')",369,1,0.0034393087828202334,1.9804333188101555e-05,370
"('”', 'without')",369,1,0.0034393087828202334,1.9804333188101555e-05,370
"('official', 'who')",1,369,9.320620007642909e-06,0.007307798946409474,370
"('sjw', 'have')",369,1,0.0034393087828202334,1.9804333188101555e-05,370
"('decades', 'of')",352,16,0.003280858242690304,0.0003168693310096249,368
"('taxes', 'because')",366,2,0.0034113469227973043,3.960866637620311e-05,368
"('pew', 'research')",366,1,0.0034113469227973043,1.9804333188101555e-05,367
"('dems', '2020')",366,1,0.0034113469227973043,1.9804333188101555e-05,367
"('2020', 'victory')",366,1,0.0034113469227973043,1.9804333188101555e-05,367
"('w', 'bush')",278,89,0.0025911323621247285,0.0017625856537410386,367
"('of', 'red')",366,1,0.0034113469227973043,1.9804333188101555e-05,367
"('time', 'for')",41,325,0.0003821454203133592,0.0064364082861330055,366
"('a', 'new')",53,313,0.0004939928604050742,0.006198756287875787,366
"('fan', 'of')",364,2,0.0033927056827820186,3.960866637620311e-05,366
"('intend', 'to')",358,7,0.0033367819627361612,0.0001386303323167109,365
"('appalling', 'excuse')",1,364,9.320620007642909e-06,0.007208777280468967,365
"('public', 'servant')",1,364,9.320620007642909e-06,0.007208777280468967,365
"('us', 'marine')",363,2,0.0033833850627743756,3.960866637620311e-05,365
"('of', 'drunk')",363,1,0.0033833850627743756,1.9804333188101555e-05,364
"('drunk', 'driving')",363,1,0.0033833850627743756,1.9804333188101555e-05,364
"('driving', 'charged')",363,1,0.0033833850627743756,1.9804333188101555e-05,364
"('refugee', 'convicted')",363,1,0.0033833850627743756,1.9804333188101555e-05,364
"('marine', 'veterans')",363,1,0.0033833850627743756,1.9804333188101555e-05,364
"('victory', '–')",363,1,0.0033833850627743756,1.9804333188101555e-05,364
"('veterans', 'their')",363,1,0.0033833850627743756,1.9804333188101555e-05,364
"('their', 'spouses')",363,1,0.0033833850627743756,1.9804333188101555e-05,364
"('–', 'americans')",363,1,0.0033833850627743756,1.9804333188101555e-05,364
"('red', 'china')",363,1,0.0033833850627743756,1.9804333188101555e-05,364
"('booker', 'on')",363,1,0.0033833850627743756,1.9804333188101555e-05,364
"('mass', 'murderer')",362,1,0.003374064442766733,1.9804333188101555e-05,363
"('theyre', '‘')",362,1,0.003374064442766733,1.9804333188101555e-05,363
"('murderer', 'fan')",362,1,0.003374064442766733,1.9804333188101555e-05,363
"('after', 'no')",361,1,0.00336474382275909,1.9804333188101555e-05,362
"('winning', 'tickets')",361,1,0.00336474382275909,1.9804333188101555e-05,362
"('no', 'winning')",361,1,0.00336474382275909,1.9804333188101555e-05,362
"('draft', 'lottery')",361,1,0.00336474382275909,1.9804333188101555e-05,362
"('lottery', 'swells')",361,1,0.00336474382275909,1.9804333188101555e-05,362
"('williamsons', 'after')",361,1,0.00336474382275909,1.9804333188101555e-05,362
"('swells', 'to')",361,1,0.00336474382275909,1.9804333188101555e-05,362
"('to', '3')",361,1,0.00336474382275909,1.9804333188101555e-05,362
"('3', 'zion')",361,1,0.00336474382275909,1.9804333188101555e-05,362
"('zion', 'williamsons')",361,1,0.00336474382275909,1.9804333188101555e-05,362
"('nba', 'draft')",361,1,0.00336474382275909,1.9804333188101555e-05,362
"('tickets', 'drawn')",360,1,0.003355423202751447,1.9804333188101555e-05,361
"('at', 'this')",324,37,0.0030198808824763025,0.0007327603279597576,361
"('first', 'overall')",358,1,0.0033367819627361612,1.9804333188101555e-05,359
"('overall', 'out')",358,1,0.0033367819627361612,1.9804333188101555e-05,359
"('draft', 'first')",358,1,0.0033367819627361612,1.9804333188101555e-05,359
"('of', 'habit')",357,1,0.003327461342728518,1.9804333188101555e-05,358
"('browns', 'draft')",357,1,0.003327461342728518,1.9804333188101555e-05,358
"('alien', 'accused')",356,1,0.0033181407227208756,1.9804333188101555e-05,357
"('anti', 'trump')",241,116,0.002246269421841941,0.0022973026498197806,357
"('mark', 'levin')",356,1,0.0033181407227208756,1.9804333188101555e-05,357
"('pay', 'one')",356,1,0.0033181407227208756,1.9804333188101555e-05,357
"('one', 'damn')",356,1,0.0033181407227208756,1.9804333188101555e-05,357
"('reparations', 'to')",356,1,0.0033181407227208756,1.9804333188101555e-05,357
"('alarmed', 'by')",1,356,9.320620007642909e-06,0.0070503426149641545,357
"('in', 'reparations')",356,1,0.0033181407227208756,1.9804333188101555e-05,357
"('checks', 'to')",348,9,0.003243575762659732,0.000178238998692914,357
"('to', 'anybody')",355,1,0.0033088201027132325,1.9804333188101555e-05,356
"('penny', 'in')",355,1,0.0033088201027132325,1.9804333188101555e-05,356
"('damn', 'penny')",355,1,0.0033088201027132325,1.9804333188101555e-05,356
"('anybody', 'period')",355,1,0.0033088201027132325,1.9804333188101555e-05,356
"('dont', 'intend')",355,1,0.0033088201027132325,1.9804333188101555e-05,356
"('foreign', 'born')",354,1,0.0032994994827055895,1.9804333188101555e-05,355
"('was', 'alarmed')",1,353,9.320620007642909e-06,0.00699092961539985,354
"('to', 'go')",319,35,0.0029732777824380877,0.0006931516615835545,354
"('left', 'in')",349,4,0.003252896382667375,7.921733275240622e-05,353
"('will', 'never')",94,258,0.0008761382807184334,0.005109517962530201,352
"('up', 'dummy')",350,1,0.0032622170026750177,1.9804333188101555e-05,351
"('we', 'want')",309,42,0.0028800715823616586,0.0008317819939002653,351
"('interfered', 'in')",1,349,9.320620007642909e-06,0.006911712282647443,350
"('pages', 'left')",348,1,0.003243575762659732,1.9804333188101555e-05,349
"('patrioticshut', 'up')",348,1,0.003243575762659732,1.9804333188101555e-05,349
"('‘', 'patrioticshut')",348,1,0.003243575762659732,1.9804333188101555e-05,349
"('willed', 'intellectual')",348,1,0.003243575762659732,1.9804333188101555e-05,349
"('intellectual', 'infant')",348,1,0.003243575762659732,1.9804333188101555e-05,349
"('more', 'pages')",348,1,0.003243575762659732,1.9804333188101555e-05,349
"('weak', 'willed')",348,1,0.003243575762659732,1.9804333188101555e-05,349
"('infant', 'checks')",348,1,0.003243575762659732,1.9804333188101555e-05,349
"('staff', 'under')",1,348,9.320620007642909e-06,0.006891907949459342,349
"('in', 'book')",348,1,0.003243575762659732,1.9804333188101555e-05,349
"('book', 'chapter')",348,1,0.003243575762659732,1.9804333188101555e-05,349
"('like', 'this')",87,261,0.000810893940664933,0.005168930962094506,348
"('supreme', 'court')",1,347,9.320620007642909e-06,0.00687210361627124,348
"('burger', 'king')",346,1,0.0032249345226444464,1.9804333188101555e-05,347
"('king', 'introduces')",346,1,0.0032249345226444464,1.9804333188101555e-05,347
"('introduce', 'bill')",301,46,0.0028055066223005155,0.0009109993266526716,347
"('is', 'not')",89,258,0.0008295351806802189,0.005109517962530201,347
"('ukraine', 'dealings')",1,346,9.320620007642909e-06,0.006852299283083139,347
"('none', 'recalled')",1,344,9.320620007642909e-06,0.006812690616706935,345
"('people', 'are')",329,16,0.003066483982514517,0.0003168693310096249,345
"('another', 'one')",17,325,0.00015845054012992945,0.0064364082861330055,342
"('they', 'are')",130,212,0.0012116806009935782,0.00419851863587753,342
"('in', 'syria')",232,109,0.0021623838417731546,0.0021586723175030698,341
"('maze', 'with')",338,1,0.003150369562583303,1.9804333188101555e-05,339
"('trials', 'following')",338,1,0.003150369562583303,1.9804333188101555e-05,339
"('testing', 'on')",338,1,0.003150369562583303,1.9804333188101555e-05,339
"('twice', 'the')",312,27,0.0029080334423845873,0.000534716996078742,339
"('with', 'cheese')",338,1,0.003150369562583303,1.9804333188101555e-05,339
"('of', 'testing')",338,1,0.003150369562583303,1.9804333188101555e-05,339
"('following', 'decades')",338,1,0.003150369562583303,1.9804333188101555e-05,339
"('on', 'mice')",338,1,0.003150369562583303,1.9804333188101555e-05,339
"('human', 'trials')",338,1,0.003150369562583303,1.9804333188101555e-05,339
"('in', 'center')",338,1,0.003150369562583303,1.9804333188101555e-05,339
"('enters', 'human')",338,1,0.003150369562583303,1.9804333188101555e-05,339
"('cheese', 'in')",338,1,0.003150369562583303,1.9804333188101555e-05,339
"('center', 'enters')",338,1,0.003150369562583303,1.9804333188101555e-05,339
"('house', 'democrats')",292,47,0.0027216210422317294,0.0009308036598407732,339
"('on', 'tuesday')",297,40,0.0027682241422699438,0.0007921733275240623,337
"('by', 'trumps')",2,334,1.8641240015285817e-05,0.00661464728482592,336
"('to', 'file')",2,334,1.8641240015285817e-05,0.00661464728482592,336
"('1', 'billion')",312,23,0.0029080334423845873,0.0004554996633263358,335
"('according', 'to')",262,72,0.002442002442002442,0.001425911989543312,334
"('recalled', 'any')",1,333,9.320620007642909e-06,0.006594842951637818,334
"('10', 'former')",1,333,9.320620007642909e-06,0.006594842951637818,334
"('adam', 'schiff')",2,331,1.8641240015285817e-05,0.006555234285261616,333
"('file', 'his')",1,332,9.320620007642909e-06,0.006575038618449717,333
"('chicago', 'police')",331,1,0.0030851252225298025,1.9804333188101555e-05,332
"('wants', 'to')",199,132,0.0018548033815209387,0.0026141719808294053,331
"('pete', 'buttigieg')",310,21,0.0028893922023693016,0.00041589099695013267,331
"('election', 'is')",1,330,9.320620007642909e-06,0.0065354299520735135,331
"('veritas', 'google')",329,1,0.003066483982514517,1.9804333188101555e-05,330
"('notre', 'dame')",329,1,0.003066483982514517,1.9804333188101555e-05,330
"('out', 'for')",65,265,0.0006058403004967891,0.005248148294846913,330
"('living', 'in')",311,18,0.0028987128223769447,0.000356477997385828,329
"('know', 'who')",14,314,0.00013048868010700072,0.006218560621063888,328
"('usa', 'today')",1,325,9.320620007642909e-06,0.0064364082861330055,326
"('us', 'diplomat')",1,325,9.320620007642909e-06,0.0064364082861330055,326
"('in', '2018')",313,13,0.0029173540623922303,0.00025745633144532023,326
"('his', 'presidential')",1,324,9.320620007642909e-06,0.006416603952944904,325
"('democrats', 'to')",305,19,0.0028427891023310873,0.0003762823305739296,324
"('on', 'our')",268,56,0.0024979261620482994,0.0011090426585336872,324
"('police', 'believe')",322,1,0.0030012396424610164,1.9804333188101555e-05,323
"('what', 'a')",193,130,0.0017988796614750813,0.0025745633144532024,323
"('intel', 'official')",1,322,9.320620007642909e-06,0.006376995286568701,323
"('to', 'testify')",1,321,9.320620007642909e-06,0.0063571909533806,322
"('im', 'calling')",321,1,0.002991919022453374,1.9804333188101555e-05,322
"('2018', 'to')",312,10,0.0029080334423845873,0.00019804333188101558,322
"('sure', 'how')",321,1,0.002991919022453374,1.9804333188101555e-05,322
"('more', 'direct')",1,321,9.320620007642909e-06,0.0063571909533806,322
"('ukraine', 'to')",1,321,9.320620007642909e-06,0.0063571909533806,322
"('at', 'a')",174,147,0.001621787881329866,0.0029112369786509287,321
"('it', 'to')",267,54,0.0024886055420406564,0.001069433992157484,321
"('repair', 'only')",320,1,0.0029825984024457308,1.9804333188101555e-05,321
"('dame', 'repair')",320,1,0.0029825984024457308,1.9804333188101555e-05,321
"('emmanuel', 'macron')",320,1,0.0029825984024457308,1.9804333188101555e-05,321
"('macron', 'not')",320,1,0.0029825984024457308,1.9804333188101555e-05,321
"('tell', 'billionaires')",320,1,0.0029825984024457308,1.9804333188101555e-05,321
"('only', 'costs')",320,1,0.0029825984024457308,1.9804333188101555e-05,321
"('billionaires', 'notre')",320,1,0.0029825984024457308,1.9804333188101555e-05,321
"('costs', '200')",320,1,0.0029825984024457308,1.9804333188101555e-05,321
"('this', 'story')",233,87,0.0021717044617807976,0.0017229769873648355,320
"('launches', 'apprenticeship')",318,1,0.0029639571624304447,1.9804333188101555e-05,319
"('plan', 'would')",313,6,0.0029173540623922303,0.00011882599912860934,319
"('apprenticeship', 'website')",318,1,0.0029639571624304447,1.9804333188101555e-05,319
"('administration', 'launches')",318,1,0.0029639571624304447,1.9804333188101555e-05,319
"('the', 'presidents')",149,169,0.0013887723811387934,0.003346932308789163,318
"('we', 'will')",275,42,0.0025631705021018,0.0008317819939002653,317
"('second', 'intel')",1,316,9.320620007642909e-06,0.006258169287440092,317
"('pushed', 'for')",26,290,0.00024233612019871562,0.005743256624549452,316
"('vote', 'from')",315,1,0.002935995302407516,1.9804333188101555e-05,316
"('rapists', 'to')",315,1,0.002935995302407516,1.9804333188101555e-05,316
"('us', 'are')",302,14,0.002814827242308158,0.0002772606646334218,316
"('claim', 'to')",304,11,0.002833468482323444,0.00021784766506911712,315
"('the', 'wall')",291,24,0.0027123004222240864,0.0004753039965144374,315
"('has', 'to')",29,285,0.0002702979802216443,0.005644234958608944,314
"('murderers', '164k')",313,1,0.0029173540623922303,1.9804333188101555e-05,314
"('183k', 'murderers')",313,1,0.0029173540623922303,1.9804333188101555e-05,314
"('164k', 'rapists')",313,1,0.0029173540623922303,1.9804333188101555e-05,314
"('would', 'allow')",313,1,0.0029173540623922303,1.9804333188101555e-05,314
"('she', 'is')",70,243,0.0006524434005350035,0.0048124529647086784,313
"('us', 'population')",312,1,0.0029080334423845873,1.9804333188101555e-05,313
"('breaking', 'news')",5,308,4.660310003821454e-05,0.006099734621935279,313
"('the', 'former')",2,311,1.8641240015285817e-05,0.006159147621499584,313
"('allow', '183k')",312,1,0.0029080334423845873,1.9804333188101555e-05,313
"('seize', 'enough')",312,1,0.0029080334423845873,1.9804333188101555e-05,313
"('fentanyl', 'in')",312,1,0.0029080334423845873,1.9804333188101555e-05,313
"('enough', 'fentanyl')",312,1,0.0029080334423845873,1.9804333188101555e-05,313
"('dealings', 'is')",1,312,9.320620007642909e-06,0.006178951954687686,313
"('nyt', 'a')",1,312,9.320620007642909e-06,0.006178951954687686,313
"('hope', 'they')",309,3,0.0028800715823616586,5.941299956430467e-05,312
"('the', 'book')",308,4,0.002870750962354016,7.921733275240622e-05,312
"('minimum', 'wage')",310,2,0.0028893922023693016,3.960866637620311e-05,312
"('feds', 'seize')",311,1,0.0028987128223769447,1.9804333188101555e-05,312
"('comes', 'forward')",1,310,9.320620007642909e-06,0.0061393432883114826,311
"('i', 'am')",170,140,0.0015845054012992945,0.002772606646334218,310
"('deadline', 'to')",1,309,9.320620007642909e-06,0.006119538955123381,310
"('bullst', 'on')",308,1,0.002870750962354016,1.9804333188101555e-05,309
"('impeachment', 'inquiry')",1,308,9.320620007642909e-06,0.006099734621935279,309
"('cortez', 'climate')",308,1,0.002870750962354016,1.9804333188101555e-05,309
"('guru', 'im')",308,1,0.002870750962354016,1.9804333188101555e-05,309
"('trump', 'for')",264,45,0.0024606436820177277,0.00089119499346457,309
"('climate', 'fakery')",308,1,0.002870750962354016,1.9804333188101555e-05,309
"('climate', 'guru')",308,1,0.002870750962354016,1.9804333188101555e-05,309
"('calling', 'bullst')",308,1,0.002870750962354016,1.9804333188101555e-05,309
"('on', 'ocasio')",308,1,0.002870750962354016,1.9804333188101555e-05,309
"('when', 'he')",216,93,0.002013253921650868,0.0018418029864934447,309
"('must', 'be')",48,260,0.0004473897603668596,0.005149126628906405,308
"('maybe', 'we')",5,303,4.660310003821454e-05,0.006000712955994771,308
"('of', 'legal')",301,7,0.0028055066223005155,0.0001386303323167109,308
"('one', 'of')",130,177,0.0012116806009935782,0.0035053669742939756,307
"('to', 'introduce')",302,5,0.002814827242308158,9.902166594050779e-05,307
"('throw', 'the')",306,1,0.00285210972233873,1.9804333188101555e-05,307
"('shows', 'that')",3,304,2.7961860022928726e-05,0.006020517289182873,307
"('book', 'at')",305,1,0.0028427891023310873,1.9804333188101555e-05,306
"('committed', 'by')",303,2,0.002824147862315801,3.960866637620311e-05,305
"('that', 'maybe')",1,304,9.320620007642909e-06,0.006020517289182873,305
"('this', 'disgusting')",304,1,0.002833468482323444,1.9804333188101555e-05,305
"('this', 'notion')",2,303,1.8641240015285817e-05,0.006000712955994771,305
"('is', 'this')",225,79,0.0020971395017196546,0.001564542321860023,304
"('we', 'living')",303,1,0.002824147862315801,1.9804333188101555e-05,304
"('universe', 'are')",303,1,0.002824147862315801,1.9804333188101555e-05,304
"('who', 'interfered')",1,303,9.320620007642909e-06,0.006000712955994771,304
"('alternate', 'universe')",303,1,0.002824147862315801,1.9804333188101555e-05,304
"('pedophile', 'rapist')",303,1,0.002824147862315801,1.9804333188101555e-05,304
"('veilwhat', 'alternate')",303,1,0.002824147862315801,1.9804333188101555e-05,304
"('disgusting', 'pedophile')",303,1,0.002824147862315801,1.9804333188101555e-05,304
"('remove', 'veilwhat')",303,1,0.002824147862315801,1.9804333188101555e-05,304
"('from', 'prison')",303,1,0.002824147862315801,1.9804333188101555e-05,304
"('is', 'detached')",1,303,9.320620007642909e-06,0.006000712955994771,304
"('notion', 'advanced')",1,303,9.320620007642909e-06,0.006000712955994771,304
"('detached', 'from')",1,303,9.320620007642909e-06,0.006000712955994771,304
"('by', 'pompeo')",1,303,9.320620007642909e-06,0.006000712955994771,304
"('gun', 'sales')",303,1,0.002824147862315801,1.9804333188101555e-05,304
"('advanced', 'by')",1,303,9.320620007642909e-06,0.006000712955994771,304
"('pompeo', 'that')",1,303,9.320620007642909e-06,0.006000712955994771,304
"('from', 'realityala')",1,303,9.320620007642909e-06,0.006000712955994771,304
"('they', 'throw')",303,1,0.002824147862315801,1.9804333188101555e-05,304
"('jerry', 'nadler')",1,303,9.320620007642909e-06,0.006000712955994771,304
"('the', 'crimes')",302,1,0.002814827242308158,1.9804333188101555e-05,303
"('is', 'awesome')",299,4,0.0027868653822852294,7.921733275240622e-05,303
"('immigrants', 'too')",301,1,0.0028055066223005155,1.9804333188101555e-05,302
"('conspiracy', 'theory')",1,301,9.320620007642909e-06,0.005961104289618569,302
"('too', '100')",301,1,0.0028055066223005155,1.9804333188101555e-05,302
"('is', 'why')",87,215,0.000810893940664933,0.004257931635441835,302
"('crimes', 'of')",301,1,0.0028055066223005155,1.9804333188101555e-05,302
"('isis', 'crimes')",301,1,0.0028055066223005155,1.9804333188101555e-05,302
"('criminalizing', 'private')",301,1,0.0028055066223005155,1.9804333188101555e-05,302
"('bill', 'criminalizing')",301,1,0.0028055066223005155,1.9804333188101555e-05,302
"('of', 'isis')",301,1,0.0028055066223005155,1.9804333188101555e-05,302
"('are', 'committed')",301,1,0.0028055066223005155,1.9804333188101555e-05,302
"('by', 'legal')",301,1,0.0028055066223005155,1.9804333188101555e-05,302
"('private', 'gun')",301,1,0.0028055066223005155,1.9804333188101555e-05,302
"('george', 'w')",278,23,0.0025911323621247285,0.0004554996633263358,301
"('knowledge', 'of')",2,298,1.8641240015285817e-05,0.005901691290054264,300
"('awesome', 'trump')",299,1,0.0027868653822852294,1.9804333188101555e-05,300
"('ukraine', 'controversy')",1,299,9.320620007642909e-06,0.005921495623242365,300
"('sales', 'on')",298,1,0.002777544762277587,1.9804333188101555e-05,299
"('health', 'care')",121,178,0.0011277950209247919,0.0035251713074820772,299
"('think', 'the')",9,288,8.388558006878618e-05,0.005703647958173248,297
"('tell', 'you')",288,9,0.0026843385622011577,0.000178238998692914,297
"('on', 'track')",295,2,0.002749582902254658,3.960866637620311e-05,297
"('thousands', 'of')",265,31,0.0024699643020253707,0.0006139343288311483,296
"('with', 'ukraine')",1,295,9.320620007642909e-06,0.00584227829048996,296
"('in', 'america')",176,120,0.001640429121345152,0.002376519982572187,296
"('5th', 'consecutive')",295,1,0.002749582902254658,1.9804333188101555e-05,296
"('planned', 'parenthood')",294,2,0.002740262282247015,3.960866637620311e-05,296
"('need', 'to')",183,112,0.0017056734613986521,0.0022180853170673744,295
"('up', 'in')",226,69,0.002106460121727297,0.0013664989899790075,295
"('for', 'them')",290,5,0.0027029798022164433,9.902166594050779e-05,295
"('of', 'energy')",293,2,0.002730941662239372,3.960866637620311e-05,295
"('get', '100')",294,1,0.002740262282247015,1.9804333188101555e-05,295
"('with', 'more')",3,292,2.7961860022928726e-05,0.005782865290925654,295
"('republican', 'senators')",1,294,9.320620007642909e-06,0.0058224739573018575,295
"('consecutive', 'year')",294,1,0.002740262282247015,1.9804333188101555e-05,295
"('to', 'top')",291,4,0.0027123004222240864,7.921733275240622e-05,295
"('energy', 'from')",293,1,0.002730941662239372,1.9804333188101555e-05,294
"('wall', 'outlet')",293,1,0.002730941662239372,1.9804333188101555e-05,294
"('outlet', 'in')",293,1,0.002730941662239372,1.9804333188101555e-05,294
"('in', 'finland')",293,1,0.002730941662239372,1.9804333188101555e-05,294
"('finland', 'by')",293,1,0.002730941662239372,1.9804333188101555e-05,294
"('from', 'unguarded')",293,1,0.002730941662239372,1.9804333188101555e-05,294
"('by', '2030')",293,1,0.002730941662239372,1.9804333188101555e-05,294
"('about', 'him')",285,9,0.002656376702178229,0.000178238998692914,294
"('sweden', 'announces')",293,1,0.002730941662239372,1.9804333188101555e-05,294
"('announces', 'plan')",293,1,0.002730941662239372,1.9804333188101555e-05,294
"('unguarded', 'wall')",293,1,0.002730941662239372,1.9804333188101555e-05,294
"('kurt', 'volker')",1,293,9.320620007642909e-06,0.005802669624113756,294
"('told', 'them')",291,2,0.0027123004222240864,3.960866637620311e-05,293
"('good', 'for')",161,132,0.0015006198212305082,0.0026141719808294053,293
"('transgender', 'athletes')",292,1,0.0027216210422317294,1.9804333188101555e-05,293
"('homicides', 'on')",291,1,0.0027123004222240864,1.9804333188101555e-05,292
"('to', 'call')",3,289,2.7961860022928726e-05,0.0057234522913613495,292
"('track', 'to')",291,1,0.0027123004222240864,1.9804333188101555e-05,292
"('i', 'told')",278,14,0.0025911323621247285,0.0002772606646334218,292
"('immigrants', 'not')",271,21,0.002525888022071228,0.00041589099695013267,292
"('top', '300')",291,1,0.0027123004222240864,1.9804333188101555e-05,292
"('300', 'for')",290,1,0.0027029798022164433,1.9804333188101555e-05,291
"('of', 'his')",69,222,0.0006431227805273607,0.004396561967758545,291
"('whistleblower', 'comes')",1,290,9.320620007642909e-06,0.005743256624549452,291
"('this', 'isnt')",200,90,0.0018641240015285817,0.00178238998692914,290
"('nearly', 'twice')",289,1,0.0026936591822088007,1.9804333188101555e-05,290
"('kill', 'nearly')",289,1,0.0026936591822088007,1.9804333188101555e-05,290
"('for', '5th')",288,1,0.0026843385622011577,1.9804333188101555e-05,289
"('action', 'breitbart')",288,1,0.0026843385622011577,1.9804333188101555e-05,289
"('to', 'include')",288,1,0.0026843385622011577,1.9804333188101555e-05,289
"('how', 'about')",131,158,0.001221001221001221,0.003129084643720046,289
"('breaking', 'chicago')",288,1,0.0026843385622011577,1.9804333188101555e-05,289
"('of', 'fun')",287,1,0.0026750179421935146,1.9804333188101555e-05,288
"('to', 'two')",274,14,0.002553849882094157,0.0002772606646334218,288
"('subpoena', 'deadline')",1,287,9.320620007642909e-06,0.005683843624985147,288
"('to', 'produce')",1,287,9.320620007642909e-06,0.005683843624985147,288
"('house', 'subpoena')",1,286,9.320620007642909e-06,0.005664039291797045,287
"('senators', 'pushed')",1,286,9.320620007642909e-06,0.005664039291797045,287
"('who', 'has')",152,135,0.001416734241161722,0.0026735849803937103,287
"('articles', 'about')",286,1,0.0026656973221858716,1.9804333188101555e-05,287
"('quirks', 'to')",285,1,0.002656376702178229,1.9804333188101555e-05,286
"('personality', 'quirks')",285,1,0.002656376702178229,1.9804333188101555e-05,286
"('buttigieg', 'releases')",285,1,0.002656376702178229,1.9804333188101555e-05,286
"('include', 'in')",285,1,0.002656376702178229,1.9804333188101555e-05,286
"('in', 'articles')",285,1,0.002656376702178229,1.9804333188101555e-05,286
"('comprehensive', 'list')",285,1,0.002656376702178229,1.9804333188101555e-05,286
"('fun', 'personality')",285,1,0.002656376702178229,1.9804333188101555e-05,286
"('releases', 'comprehensive')",285,1,0.002656376702178229,1.9804333188101555e-05,286
"('be', 'on')",6,280,5.592372004585745e-05,0.005545213292668436,286
"('to', 'cnn')",259,25,0.0024140405819795133,0.0004951083297025389,284
"('meet', 'house')",1,283,9.320620007642909e-06,0.00560462629223274,284
"('reforms', 'to')",1,283,9.320620007642909e-06,0.00560462629223274,284
"('ought', 'to')",3,280,2.7961860022928726e-05,0.005545213292668436,283
"('im', 'a')",278,5,0.0025911323621247285,9.902166594050779e-05,283
"('to', 'female')",282,1,0.0026284148421553003,1.9804333188101555e-05,283
"('new', 'a')",1,281,9.320620007642909e-06,0.005565017625856538,282
"('produce', 'ukraine')",1,281,9.320620007642909e-06,0.005565017625856538,282
"('has', 'backfired')",1,281,9.320620007642909e-06,0.005565017625856538,282
"('baltimore', 'homicides')",280,1,0.002609773602140014,1.9804333188101555e-05,281
"('far', 'left')",240,41,0.002236948801834298,0.0008119776607121638,281
"('breitbart', 'http')",280,1,0.002609773602140014,1.9804333188101555e-05,281
"('to', 'keep')",56,225,0.0005219547204280029,0.00445597496732285,281
"('doesnt', 'want')",235,45,0.0021903457017960833,0.00089119499346457,280
"('to', 'hit')",277,3,0.0025818117421170855,5.941299956430467e-05,280
"('he', 'wants')",187,92,0.0017429559414292239,0.0018219986533053432,279
"('highest', 'level')",277,2,0.0025818117421170855,3.960866637620311e-05,279
"('filled', 'trench')",1,278,9.320620007642909e-06,0.005505604626292232,279
"('with', 'snakes')",1,278,9.320620007642909e-06,0.005505604626292232,279
"('level', 'since')",277,2,0.0025818117421170855,3.960866637620311e-05,279
"('diplomat', 'to')",1,278,9.320620007642909e-06,0.005505604626292232,279
"('and', 'it')",230,48,0.002143742601757869,0.0009506079930288747,278
"('them', 'not')",277,1,0.0025818117421170855,1.9804333188101555e-05,278
"('hit', 'highest')",277,1,0.0025818117421170855,1.9804333188101555e-05,278
"('john', 'hickenlooper')",1,277,9.320620007642909e-06,0.005485800293104131,278
"('since', 'george')",277,1,0.0025818117421170855,1.9804333188101555e-05,278
"('to', 'act')",231,47,0.002153063221765512,0.0009308036598407732,278
"('weightlifting', 'records')",277,1,0.0025818117421170855,1.9804333188101555e-05,278
"('female', 'weightlifting')",277,1,0.0025818117421170855,1.9804333188101555e-05,278
"('‘', 'i')",266,12,0.0024792849220330137,0.0002376519982572187,278
"('newly', 'unearthed')",1,276,9.320620007642909e-06,0.00546599595991603,277
"('ukraines', 'prosecutor')",1,276,9.320620007642909e-06,0.00546599595991603,277
"('rejects', 'transgender')",276,1,0.002572491122109443,1.9804333188101555e-05,277
"('athletes', 'claim')",276,1,0.002572491122109443,1.9804333188101555e-05,277
"('behind', 'sending')",275,1,0.0025631705021018,1.9804333188101555e-05,276
"('told', 'police')",275,1,0.0025631705021018,1.9804333188101555e-05,276
"('committing', 'crimes')",2,274,1.8641240015285817e-05,0.0054263872935398265,276
"('brothers', 'told')",275,1,0.0025631705021018,1.9804333188101555e-05,276
"('hate', 'letter')",275,1,0.0025631705021018,1.9804333188101555e-05,276
"('a', 'mom')",274,2,0.002553849882094157,3.960866637620311e-05,276
"('mom', 'to')",274,2,0.002553849882094157,3.960866637620311e-05,276
"('sending', 'himself')",275,1,0.0025631705021018,1.9804333188101555e-05,276
"('impeachment', 'probe')",1,275,9.320620007642909e-06,0.005446191626727928,276
"('himself', 'hate')",275,1,0.0025631705021018,1.9804333188101555e-05,276
"('president', 'ought')",1,275,9.320620007642909e-06,0.005446191626727928,276
"('because', 'there')",274,2,0.002553849882094157,3.960866637620311e-05,276
"('go', 'into')",275,1,0.0025631705021018,1.9804333188101555e-05,276
"('technology', 'because')",274,1,0.002553849882094157,1.9804333188101555e-05,275
"('rachel', 'maddow')",274,1,0.002553849882094157,1.9804333188101555e-05,275
"('forward', 'after')",1,274,9.320620007642909e-06,0.0054263872935398265,275
"('speaking', 'with')",1,274,9.320620007642909e-06,0.0054263872935398265,275
"('impeached', 'but')",1,274,9.320620007642909e-06,0.0054263872935398265,275
"('but', 'public')",1,274,9.320620007642909e-06,0.0054263872935398265,275
"('future', 'for')",274,1,0.002553849882094157,1.9804333188101555e-05,275
"('not', 'going')",254,21,0.002367437481941299,0.00041589099695013267,275
"('into', 'technology')",274,1,0.002553849882094157,1.9804333188101555e-05,275
"('two', 'beautiful')",274,1,0.002553849882094157,1.9804333188101555e-05,275
"('immigration', 'expected')",274,1,0.002553849882094157,1.9804333188101555e-05,275
"('no', 'future')",274,1,0.002553849882094157,1.9804333188101555e-05,275
"('beautiful', 'girls')",274,1,0.002553849882094157,1.9804333188101555e-05,275
"('girls', 'and')",274,1,0.002553849882094157,1.9804333188101555e-05,275
"('the', 'best')",239,36,0.002227628181826655,0.000712955994771656,275
"('smollett', 'behind')",273,1,0.002544529262086514,1.9804333188101555e-05,274
"('criticism', 'of')",250,24,0.002330155001910727,0.0004753039965144374,274
"('after', 'speaking')",1,273,9.320620007642909e-06,0.005406582960351725,274
"('really', '👇❌👇❌👇❌👇kamala')",273,1,0.002544529262086514,1.9804333188101555e-05,274
"('with', 'ig')",1,273,9.320620007642909e-06,0.005406582960351725,274
"('👇❌👇❌👇❌👇kamala', 'harris')",273,1,0.002544529262086514,1.9804333188101555e-05,274
"('former', 'white')",1,272,9.320620007642909e-06,0.005386778627163623,273
"('of', 'national')",188,85,0.0017522765614368667,0.0016833683209886323,273
"('ending', 'his')",1,272,9.320620007642909e-06,0.005386778627163623,273
"('house', 'chiefs')",1,271,9.320620007642909e-06,0.005366974293975522,272
"('immigration', 'policy')",266,6,0.0024792849220330137,0.00011882599912860934,272
"('can', 'be')",241,31,0.002246269421841941,0.0006139343288311483,272
"('lewandowski', 'frustrates')",1,270,9.320620007642909e-06,0.005347169960787421,271
"('police', 'jussie')",270,1,0.0025165674020635855,1.9804333188101555e-05,271
"('tax', 'returns')",6,265,5.592372004585745e-05,0.005248148294846913,271
"('behind', 'the')",254,17,0.002367437481941299,0.00033667366419772645,271
"('league', 'rejects')",269,1,0.0025072467820559424,1.9804333188101555e-05,270
"('official', 'with')",1,269,9.320620007642909e-06,0.005327365627599319,270
"('he', 'still')",265,4,0.0024699643020253707,7.921733275240622e-05,269
"('billion', 'from')",259,10,0.0024140405819795133,0.00019804333188101558,269
"('nadler', 'i')",1,268,9.320620007642909e-06,0.005307561294411217,269
"('his', 'immigration')",266,2,0.0024792849220330137,3.960866637620311e-05,268
"('policy', 'on')",265,3,0.0024699643020253707,5.941299956430467e-05,268
"('new', 'national')",1,266,9.320620007642909e-06,0.005267952628035014,267
"('islamic', 'state')",266,1,0.0024792849220330137,1.9804333188101555e-05,267
"('public', 'has')",1,265,9.320620007642909e-06,0.005248148294846913,266
"('its', 'a')",40,226,0.00037282480030571634,0.004475779300510952,266
"('from', 'california')",258,8,0.0024047199619718703,0.00015843466550481244,266
"('whistleblower', 'who')",1,265,9.320620007642909e-06,0.005248148294846913,266
"('deported', 'illegal')",264,1,0.0024606436820177277,1.9804333188101555e-05,265
"('to', 'surpass')",261,3,0.002432681821994799,5.941299956430467e-05,264
"('cbs', 'brothers')",263,1,0.002451323062010085,1.9804333188101555e-05,264
"('mavericks', 'retire')",263,1,0.002451323062010085,1.9804333188101555e-05,264
"('dirk', 'nowitzkis')",263,1,0.002451323062010085,1.9804333188101555e-05,264
"('nowitzkis', 'jersey')",263,1,0.002451323062010085,1.9804333188101555e-05,264
"('jersey', 'fully')",263,1,0.002451323062010085,1.9804333188101555e-05,264
"('fully', 'unaware')",263,1,0.002451323062010085,1.9804333188101555e-05,264
"('unaware', 'he')",263,1,0.002451323062010085,1.9804333188101555e-05,264
"('still', 'on')",263,1,0.002451323062010085,1.9804333188101555e-05,264
"('have', 'an')",261,3,0.002432681821994799,5.941299956430467e-05,264
"('on', 'team')",263,1,0.002451323062010085,1.9804333188101555e-05,264
"('presidential', 'bid')",1,263,9.320620007642909e-06,0.005208539628470709,264
"('movie', 'plot')",263,1,0.002451323062010085,1.9804333188101555e-05,264
"('retire', 'dirk')",263,1,0.002451323062010085,1.9804333188101555e-05,264
"('to', 'face')",244,20,0.00227423128186487,0.00039608666376203115,264
"('a', 'fictional')",261,3,0.002432681821994799,5.941299956430467e-05,264
"('in', 'front')",166,97,0.0015472229212687228,0.001921020319245851,263
"('obama', 'era')",261,2,0.002432681821994799,3.960866637620311e-05,263
"('with', 'congress')",1,262,9.320620007642909e-06,0.005188735295282608,263
"('a', 'water')",2,261,1.8641240015285817e-05,0.005168930962094506,263
"('for', 'basing')",261,1,0.002432681821994799,1.9804333188101555e-05,262
"('trump', 'takes')",260,2,0.0024233612019871563,3.960866637620311e-05,262
"('the', 'call')",1,261,9.320620007642909e-06,0.005168930962094506,262
"('immigration', 'under')",261,1,0.002432681821994799,1.9804333188101555e-05,262
"('surpass', 'obama')",261,1,0.002432681821994799,1.9804333188101555e-05,262
"('in', 'an')",187,75,0.0017429559414292239,0.0014853249891076167,262
"('border', 'wall')",16,246,0.00014912992012228654,0.004871865964272983,262
"('fictional', 'movie')",261,1,0.002432681821994799,1.9804333188101555e-05,262
"('candace', 'owens')",261,1,0.002432681821994799,1.9804333188101555e-05,262
"('basing', 'his')",261,1,0.002432681821994799,1.9804333188101555e-05,262
"('takes', 'back')",260,1,0.0024233612019871563,1.9804333188101555e-05,261
"('water', 'filled')",1,260,9.320620007642909e-06,0.005149126628906405,261
"('from', 'boston')",260,1,0.0024233612019871563,1.9804333188101555e-05,261
"('because', 'he')",194,67,0.0018082002814827243,0.0013268903236028043,261
"('era', 'levels')",260,1,0.0024233612019871563,1.9804333188101555e-05,261
"('call', 'him')",2,258,1.8641240015285817e-05,0.005109517962530201,260
"('won', 'american')",259,1,0.0024140405819795133,1.9804333188101555e-05,260
"('trump', 'projected')",259,1,0.0024140405819795133,1.9804333188101555e-05,260
"('american', 'born')",259,1,0.0024140405819795133,1.9804333188101555e-05,260
"('polls', 'trump')",259,1,0.0024140405819795133,1.9804333188101555e-05,260
"('cnn', 'exit')",259,1,0.0024140405819795133,1.9804333188101555e-05,260
"('on', 'his')",5,255,4.660310003821454e-05,0.005050104962965897,260
"('exit', 'polls')",259,1,0.0024140405819795133,1.9804333188101555e-05,260
"('trump', 'was')",82,178,0.0007642908406267185,0.0035251713074820772,260
"('born', 'citizens')",259,1,0.0024140405819795133,1.9804333188101555e-05,260
"('lost', 'foreign')",259,1,0.0024140405819795133,1.9804333188101555e-05,260
"('but', 'lost')",259,1,0.0024140405819795133,1.9804333188101555e-05,260
"('degree', 'from')",259,1,0.0024140405819795133,1.9804333188101555e-05,260
"('nbc', 'news')",1,259,9.320620007642909e-06,0.0051293222957183035,260
"('born', 'voters')",259,1,0.0024140405819795133,1.9804333188101555e-05,260
"('49', '45')",259,1,0.0024140405819795133,1.9804333188101555e-05,260
"('maddow', 'busts')",259,1,0.0024140405819795133,1.9804333188101555e-05,260
"('voters', '49')",259,1,0.0024140405819795133,1.9804333188101555e-05,260
"('45', 'but')",259,1,0.0024140405819795133,1.9804333188101555e-05,260
"('busts', 'trump')",259,1,0.0024140405819795133,1.9804333188101555e-05,260
"('nothing', 'to')",15,244,0.00013980930011464363,0.00483225729789678,259
"('for', 'solicitin')",1,258,9.320620007642909e-06,0.005109517962530201,259
"('daring', 'us')",1,258,9.320620007642909e-06,0.005109517962530201,259
"('practically', 'daring')",1,258,9.320620007642909e-06,0.005109517962530201,259
"('plain', 'sight')",1,258,9.320620007642909e-06,0.005109517962530201,259
"('prosecutor', 'generals')",1,258,9.320620007642909e-06,0.005109517962530201,259
"('sight', 'is')",1,258,9.320620007642909e-06,0.005109517962530201,259
"('is', 'intriguing')",1,258,9.320620007642909e-06,0.005109517962530201,259
"('an', 'economics')",258,1,0.0024047199619718703,1.9804333188101555e-05,259
"('intriguing', 'trump')",1,258,9.320620007642909e-06,0.005109517962530201,259
"('really', 'have')",258,1,0.0024047199619718703,1.9804333188101555e-05,259
"('is', 'practically')",1,258,9.320620007642909e-06,0.005109517962530201,259
"('in', 'plain')",1,258,9.320620007642909e-06,0.005109517962530201,259
"('of', 'committing')",1,258,9.320620007642909e-06,0.005109517962530201,259
"('citizens', '64')",258,1,0.0024047199619718703,1.9804333188101555e-05,259
"('64', '31')",258,1,0.0024047199619718703,1.9804333188101555e-05,259
"('birthright', 'citizenship')",258,1,0.0024047199619718703,1.9804333188101555e-05,259
"('trump', 're')",258,1,0.0024047199619718703,1.9804333188101555e-05,259
"('unless', 'trump')",258,1,0.0024047199619718703,1.9804333188101555e-05,259
"('31', 'unless')",258,1,0.0024047199619718703,1.9804333188101555e-05,259
"('habit', 'of')",1,258,9.320620007642909e-06,0.005109517962530201,259
"('for', 'alleged')",254,5,0.002367437481941299,9.902166594050779e-05,259
"('think', 'this')",255,4,0.0023767581019489416,7.921733275240622e-05,259
"('this', 'habit')",1,258,9.320620007642909e-06,0.005109517962530201,259
"('economics', 'degree')",258,1,0.0024047199619718703,1.9804333188101555e-05,259
"('dan', 'rather')",257,1,0.0023953993419642276,1.9804333188101555e-05,258
"('we', 'need')",123,134,0.0011464362609400777,0.0026537806472056087,257
"('ilhan', 'omars')",256,1,0.0023860787219565846,1.9804333188101555e-05,257
"('the', 'birth')",256,1,0.0023860787219565846,1.9804333188101555e-05,257
"('do', 'you')",202,55,0.0018827652415438676,0.0010892383253455855,257
"('birth', 'of')",256,1,0.0023860787219565846,1.9804333188101555e-05,257
"('gavin', 'newsom')",255,1,0.0023767581019489416,1.9804333188101555e-05,256
"('lest', 'we')",255,1,0.0023767581019489416,1.9804333188101555e-05,256
"('we', 'forget')",255,1,0.0023767581019489416,1.9804333188101555e-05,256
"('exposed', 'dan')",255,1,0.0023767581019489416,1.9804333188101555e-05,256
"('rather', 'and')",255,1,0.0023767581019489416,1.9804333188101555e-05,256
"('a', 'bunch')",199,56,0.0018548033815209387,0.0011090426585336872,255
"('attorney', 'general')",3,252,2.7961860022928726e-05,0.004990691963401592,255
"('plans', 'to')",109,146,0.001015947580833077,0.002891432645462827,255
"('a', 'newly')",1,253,9.320620007642909e-06,0.0050104962965896935,254
"('back', '1')",253,1,0.002358116861933656,1.9804333188101555e-05,254
"('a', 'white')",186,68,0.001733635321421581,0.0013466946567909058,254
"('bunch', 'of')",199,55,0.0018548033815209387,0.0010892383253455855,254
"('mr', 'trumps')",1,252,9.320620007642909e-06,0.004990691963401592,253
"('15', 'minimum')",252,1,0.002348796241926013,1.9804333188101555e-05,253
"('make', 'it')",223,29,0.0020784982617043685,0.0005743256624549452,252
"('former', 'vice')",214,38,0.0019946126816355824,0.0007525646611478592,252
"('news', 'lest')",251,1,0.00233947562191837,1.9804333188101555e-05,252
"('department', 'officials')",1,251,9.320620007642909e-06,0.004970887630213491,252
"('facebook', 'and')",250,1,0.002330155001910727,1.9804333188101555e-05,251
"('president', 'is')",17,234,0.00015845054012992945,0.004634213966015765,251
"('cair', 'backs')",250,1,0.002330155001910727,1.9804333188101555e-05,251
"('backs', 'ilhan')",250,1,0.002330155001910727,1.9804333188101555e-05,251
"('the', 'state')",38,213,0.0003541835602904305,0.004218322969065632,251
"('this', 'has')",36,215,0.0003355423202751447,0.004257931635441835,251
"('lindsey', 'graham')",11,240,0.000102526820084072,0.004753039965144374,251
"('of', 'israel')",250,1,0.002330155001910727,1.9804333188101555e-05,251
"('khans', 'london')",249,1,0.002320834381903084,1.9804333188101555e-05,250
"('under', 'whic')",1,249,9.320620007642909e-06,0.004931278963837288,250
"('circ', 'under')",1,249,9.320620007642909e-06,0.004931278963837288,250
"('legitimate', 'criticism')",249,1,0.002320834381903084,1.9804333188101555e-05,250
"('reaganbushclintonwbushampobama', 'found')",1,249,9.320620007642909e-06,0.004931278963837288,250
"('letter', 'from')",1,249,9.320620007642909e-06,0.004931278963837288,250
"('will', 'make')",171,79,0.0015938260213069373,0.001564542321860023,250
"('any', 'circ')",1,249,9.320620007642909e-06,0.004931278963837288,250
"('under', 'reaganbushclintonwbushampobama')",1,249,9.320620007642909e-06,0.004931278963837288,250
"('a', 'whistleblower')",1,248,9.320620007642909e-06,0.004911474630649186,249
"('buildthatwall', 'deportthemall')",248,1,0.002311513761895441,1.9804333188101555e-05,249
"('ag', 'barr')",1,248,9.320620007642909e-06,0.004911474630649186,249
"('election', 'how')",246,1,0.0022928725218801555,1.9804333188101555e-05,247
"('work', 'for')",6,241,5.592372004585745e-05,0.004772844298332475,247
"('combative', 'lewandowski')",1,246,9.320620007642909e-06,0.004871865964272983,247
"('what', 'he')",12,235,0.0001118474400917149,0.004654018299203866,247
"('attack', 'has')",1,246,9.320620007642909e-06,0.004871865964272983,247
"('of', 'us')",58,189,0.0005405959604432886,0.0037430189725511944,247
"('defense', 'of')",243,4,0.0022649106618572268,7.921733275240622e-05,247
"('for', 'immigrants')",245,2,0.0022835519018725124,3.960866637620311e-05,247
"('wouldnt', 'have')",244,2,0.00227423128186487,3.960866637620311e-05,246
"('do', 'not')",129,117,0.0012023599809859351,0.0023171069830078823,246
"('newsom', 'complains')",245,1,0.0022835519018725124,1.9804333188101555e-05,246
"('hand', 'knowledge')",1,245,9.320620007642909e-06,0.004852061631084882,246
"('the', 'first')",44,201,0.000410107280336288,0.003980670970808413,245
"('a', 'statement')",3,242,2.7961860022928726e-05,0.004792648631520576,245
"('not', 'americans')",244,1,0.00227423128186487,1.9804333188101555e-05,245
"('inspector', 'general')",1,244,9.320620007642909e-06,0.00483225729789678,245
"('it', 'in')",233,12,0.0021717044617807976,0.0002376519982572187,245
"('of', 'socialism')",243,2,0.0022649106618572268,3.960866637620311e-05,245
"('howard', 'schultz')",244,1,0.00227423128186487,1.9804333188101555e-05,245
"('selling', 'birthright')",244,1,0.00227423128186487,1.9804333188101555e-05,245
"('of', 'selling')",243,1,0.0022649106618572268,1.9804333188101555e-05,244
"('schultz', 'america')",243,1,0.0022649106618572268,1.9804333188101555e-05,244
"('to', 'accuse')",214,30,0.0019946126816355824,0.0005941299956430467,244
"('20', 'accused')",243,1,0.0022649106618572268,1.9804333188101555e-05,244
"('they', 'must')",225,19,0.0020971395017196546,0.0003762823305739296,244
"('exists', 'for')",243,1,0.0022649106618572268,1.9804333188101555e-05,244
"('citizenship', 'to')",243,1,0.0022649106618572268,1.9804333188101555e-05,244
"('california', 'gavin')",243,1,0.0022649106618572268,1.9804333188101555e-05,244
"('america', 'exists')",242,1,0.0022555900418495837,1.9804333188101555e-05,243
"('true', 'justice')",242,1,0.0022555900418495837,1.9804333188101555e-05,243
"('sanders', 'decades')",242,1,0.0022555900418495837,1.9804333188101555e-05,243
"('decades', 'long')",242,1,0.0022555900418495837,1.9804333188101555e-05,243
"('long', 'defense')",242,1,0.0022555900418495837,1.9804333188101555e-05,243
"('to', 'say')",195,48,0.0018175209014903672,0.0009506079930288747,243
"('—', '‘')",242,1,0.0022555900418495837,1.9804333188101555e-05,243
"('have', 'the')",33,210,0.00030758046025221596,0.004158909969501327,243
"('family', 'of')",242,1,0.0022555900418495837,1.9804333188101555e-05,243
"('california', '20')",242,1,0.0022555900418495837,1.9804333188101555e-05,243
"('make', 'the')",2,241,1.8641240015285817e-05,0.004772844298332475,243
"('were', 'not')",225,18,0.0020971395017196546,0.000356477997385828,243
"('plot', 'via')",242,1,0.0022555900418495837,1.9804333188101555e-05,243
"('announced', 'that')",1,242,9.320620007642909e-06,0.004792648631520576,243
"('sanders', 'plan')",242,1,0.0022555900418495837,1.9804333188101555e-05,243
"('ukraine', 'call')",1,242,9.320620007642909e-06,0.004792648631520576,243
"('the', 'lefts')",4,238,3.7282480030571634e-05,0.0047134312987681705,242
"('homeland', 'security')",109,133,0.001015947580833077,0.002633976314017507,242
"('alleged', 'anti')",241,1,0.002246269421841941,1.9804333188101555e-05,242
"('a', 'senior')",1,241,9.320620007642909e-06,0.004772844298332475,242
"('trump', 'conspirators')",241,1,0.002246269421841941,1.9804333188101555e-05,242
"('wouldnt', 'you')",241,1,0.002246269421841941,1.9804333188101555e-05,242
"('her', 'facts')",240,1,0.002236948801834298,1.9804333188101555e-05,241
"('tired', 'of')",229,12,0.002134421981750226,0.0002376519982572187,241
"('sports', 'league')",240,1,0.002236948801834298,1.9804333188101555e-05,241
"('conspirators', 'to')",240,1,0.002236948801834298,1.9804333188101555e-05,241
"('you', 'wont')",230,11,0.002143742601757869,0.00021784766506911712,241
"('the', 'bars')",240,1,0.002236948801834298,1.9804333188101555e-05,241
"('women', 'have')",217,24,0.002022574541658511,0.0004753039965144374,241
"('for', 'reforms')",1,240,9.320620007642909e-06,0.004753039965144374,241
"('hunter', 'bidens')",1,240,9.320620007642909e-06,0.004753039965144374,241
"('trump', 'promised')",1,240,9.320620007642909e-06,0.004753039965144374,241
"('bars', 'justice')",240,1,0.002236948801834298,1.9804333188101555e-05,241
"('this', 'numbnut')",239,1,0.002227628181826655,1.9804333188101555e-05,240
"('healthy', 'deep')",239,1,0.002227628181826655,1.9804333188101555e-05,240
"('from', '2016')",1,239,9.320620007642909e-06,0.004733235631956272,240
"('deep', 'steamed')",239,1,0.002227628181826655,1.9804333188101555e-05,240
"('french', 'fries')",239,1,0.002227628181826655,1.9804333188101555e-05,240
"('steamed', 'french')",239,1,0.002227628181826655,1.9804333188101555e-05,240
"('first', 'hand')",1,239,9.320620007642909e-06,0.004733235631956272,240
"('numbnut', 'would')",239,1,0.002227628181826655,1.9804333188101555e-05,240
"('before', 'spouting')",239,1,0.002227628181826655,1.9804333188101555e-05,240
"('would', 'check')",239,1,0.002227628181826655,1.9804333188101555e-05,240
"('rhode', 'island')",239,1,0.002227628181826655,1.9804333188101555e-05,240
"('unearthed', 'letter')",1,239,9.320620007642909e-06,0.004733235631956272,240
"('new', 'healthy')",239,1,0.002227628181826655,1.9804333188101555e-05,240
"('check', 'her')",239,1,0.002227628181826655,1.9804333188101555e-05,240
"('spouting', 'garbage')",239,1,0.002227628181826655,1.9804333188101555e-05,240
"('is', 'just')",59,181,0.0005499165804509316,0.003584584307046382,240
"('from', 'china')",4,236,3.7282480030571634e-05,0.004673822632391967,240
"('facts', 'before')",239,1,0.002227628181826655,1.9804333188101555e-05,240
"('hong', 'kong')",14,226,0.00013048868010700072,0.004475779300510952,240
"('garbage', '🤔')",239,1,0.002227628181826655,1.9804333188101555e-05,240
"('amp', 'the')",33,206,0.00030758046025221596,0.00407969263674892,239
"('in', 'jail')",233,6,0.0021717044617807976,0.00011882599912860934,239
"('so', 'does')",236,3,0.0021996663218037263,5.941299956430467e-05,239
"('never', 'learn')",2,237,1.8641240015285817e-05,0.004693626965580069,239
"('support', 'the')",173,66,0.0016124672613222232,0.0013070859904147027,239
"('lefts', 'attack')",1,237,9.320620007642909e-06,0.004693626965580069,238
"('backfired', 'again')",1,237,9.320620007642909e-06,0.004693626965580069,238
"('learn', 'the')",1,237,9.320620007642909e-06,0.004693626965580069,238
"('american', 'jobs')",237,1,0.0022089869418113694,1.9804333188101555e-05,238
"('barr', 'is')",1,237,9.320620007642909e-06,0.004693626965580069,238
"('no', 'evidence')",1,237,9.320620007642909e-06,0.004693626965580069,238
"('‘', 'legitimate')",237,1,0.0022089869418113694,1.9804333188101555e-05,238
"('omars', '‘')",237,1,0.0022089869418113694,1.9804333188101555e-05,238
"('the', 'number')",123,115,0.0011464362609400777,0.002277498316631679,238
"('descends', 'into')",1,236,9.320620007642909e-06,0.004673822632391967,237
"('evidence', 'of')",3,234,2.7961860022928726e-05,0.004634213966015765,237
"('on', 'board')",2,235,1.8641240015285817e-05,0.004654018299203866,237
"('straight', 'from')",235,2,0.0021903457017960833,3.960866637620311e-05,237
"('socialism', 'and')",236,1,0.0021996663218037263,1.9804333188101555e-05,237
"('respond', 'to')",230,7,0.002143742601757869,0.0001386303323167109,237
"('communism', 'sanderstownhall')",235,1,0.0021903457017960833,1.9804333188101555e-05,236
"('and', 'communism')",235,1,0.0021903457017960833,1.9804333188101555e-05,236
"('candid', 'camera')",235,1,0.0021903457017960833,1.9804333188101555e-05,236
"('trump', 'to')",6,230,5.592372004585745e-05,0.004554996633263358,236
"('camera', 'bernie')",234,1,0.0021810250817884407,1.9804333188101555e-05,235
"('sent', 'to')",3,232,2.7961860022928726e-05,0.004594605299639561,235
"('to', 'any')",233,2,0.0021717044617807976,3.960866637620311e-05,235
"('laying', 'off')",234,1,0.0021810250817884407,1.9804333188101555e-05,235
"('funding', 'to')",233,2,0.0021717044617807976,3.960866637620311e-05,235
"('says', 'he')",19,216,0.00017709178014521526,0.004277735968629936,235
"('play', 'fair')",234,1,0.0021810250817884407,1.9804333188101555e-05,235
"('of', 'trying')",230,5,0.002143742601757869,9.902166594050779e-05,235
"('does', 'aoc')",234,1,0.0021810250817884407,1.9804333188101555e-05,235
"('aoc', 'really')",234,1,0.0021810250817884407,1.9804333188101555e-05,235
"('face', '‘')",233,1,0.0021717044617807976,1.9804333188101555e-05,234
"('‘', 'true')",233,1,0.0021717044617807976,1.9804333188101555e-05,234
"('justice', '—')",233,1,0.0021717044617807976,1.9804333188101555e-05,234
"('‘', 'behind')",233,1,0.0021717044617807976,1.9804333188101555e-05,234
"('secretary', 'of')",9,225,8.388558006878618e-05,0.00445597496732285,234
"('that', 'republican')",1,233,9.320620007642909e-06,0.0046144096328276625,234
"('starbucks', 'howard')",233,1,0.0021717044617807976,1.9804333188101555e-05,234
"('stocked', 'with')",1,233,9.320620007642909e-06,0.0046144096328276625,234
"('species', 'act')",1,233,9.320620007642909e-06,0.0046144096328276625,234
"('2016', 'shows')",1,233,9.320620007642909e-06,0.0046144096328276625,234
"('endangered', 'species')",1,233,9.320620007642909e-06,0.0046144096328276625,234
"('in', 'trump')",177,56,0.0016497497413527947,0.0011090426585336872,233
"('says', 'hes')",1,232,9.320620007642909e-06,0.004594605299639561,233
"('stronghold', 'in')",232,1,0.0021623838417731546,1.9804333188101555e-05,233
"('be', 'arrested')",179,54,0.0016683909813680806,0.001069433992157484,233
"('bidens', 'work')",1,232,9.320620007642909e-06,0.004594605299639561,233
"('half', 'of')",229,4,0.002134421981750226,7.921733275240622e-05,233
"('to', 'come')",222,10,0.002069177641696726,0.00019804333188101558,232
"('and', 'twitter')",230,2,0.002143742601757869,3.960866637620311e-05,232
"('texas', 'border')",231,1,0.002153063221765512,1.9804333188101555e-05,232
"('hearing', 'descends')",1,231,9.320620007642909e-06,0.004574800966451459,232
"('dealings', 'with')",1,230,9.320620007642909e-06,0.004554996633263358,231
"('agile', 'dynamic')",230,1,0.002143742601757869,1.9804333188101555e-05,231
"('instead', 'of')",136,95,0.0012676043210394356,0.0018814116528696478,231
"('against', 'far')",230,1,0.002143742601757869,1.9804333188101555e-05,231
"('act', 'against')",230,1,0.002143742601757869,1.9804333188101555e-05,231
"('twitter', 'refuse')",230,1,0.002143742601757869,1.9804333188101555e-05,231
"('of', 'mike')",230,1,0.002143742601757869,1.9804333188101555e-05,231
"('mike', 'cernovich')",230,1,0.002143742601757869,1.9804333188101555e-05,231
"('before', 'the')",11,220,0.000102526820084072,0.004356953301382342,231
"('dynamic', 'company')",230,1,0.002143742601757869,1.9804333188101555e-05,231
"('off', 'half')",229,2,0.002134421981750226,3.960866637620311e-05,231
"('for', 'trump')",20,211,0.00018641240015285817,0.004178714302689428,231
"('to', 'respond')",229,1,0.002134421981750226,1.9804333188101555e-05,230
"('time', 'deported')",229,1,0.002134421981750226,1.9804333188101555e-05,230
"('challenge', 'by')",229,1,0.002134421981750226,1.9804333188101555e-05,230
"('any', 'challenge')",229,1,0.002134421981750226,1.9804333188101555e-05,230
"('by', 'laying')",229,1,0.002134421981750226,1.9804333188101555e-05,230
"('company', 'able')",229,1,0.002134421981750226,1.9804333188101555e-05,230
"('news', 'john')",1,228,9.320620007642909e-06,0.004515387966887155,229
"('forward', 'to')",216,13,0.002013253921650868,0.00025745633144532023,229
"('came', 'to')",222,7,0.002069177641696726,0.0001386303323167109,229
"('president', 'joe')",214,15,0.0019946126816355824,0.00029706499782152337,229
"('for', 'burisma')",1,228,9.320620007642909e-06,0.004515387966887155,229
"('burisma', 'prompted')",1,228,9.320620007642909e-06,0.004515387966887155,229
"('prompted', 'concerns')",1,228,9.320620007642909e-06,0.004515387966887155,229
"('concerns', 'among')",1,228,9.320620007642909e-06,0.004515387966887155,229
"('among', 'state')",1,228,9.320620007642909e-06,0.004515387966887155,229
"('officials', 'at')",1,228,9.320620007642909e-06,0.004515387966887155,229
"('fair', 'to')",228,1,0.0021251013617425833,1.9804333188101555e-05,229
"('vowing', 'to')",1,228,9.320620007642909e-06,0.004515387966887155,229
"('and', 'ukraine')",1,228,9.320620007642909e-06,0.004515387966887155,229
"('in', 'texas')",217,11,0.002022574541658511,0.00021784766506911712,228
"('mexican', 'run')",227,1,0.0021157807417349402,1.9804333188101555e-05,228
"('may', 'be')",41,187,0.0003821454203133592,0.003703410306174991,228
"('run', 'cockfight')",227,1,0.0021157807417349402,1.9804333188101555e-05,228
"('shared', 'with')",1,227,9.320620007642909e-06,0.004495583633699053,228
"('cockfight', 'in')",227,1,0.0021157807417349402,1.9804333188101555e-05,228
"('final', 'islamic')",227,1,0.0021157807417349402,1.9804333188101555e-05,228
"('msnbc', 'host')",226,2,0.002106460121727297,3.960866637620311e-05,228
"('state', 'stronghold')",227,1,0.0021157807417349402,1.9804333188101555e-05,228
"('is', 'in')",62,165,0.0005778784404738603,0.0032677149760367567,227
"('has', 'a')",41,186,0.0003821454203133592,0.0036836059729868894,227
"('to', 'jump')",226,1,0.002106460121727297,1.9804333188101555e-05,227
"('is', 'ukrainian😂')",1,226,9.320620007642909e-06,0.004475779300510952,227
"('just', 'announced')",1,226,9.320620007642909e-06,0.004475779300510952,227
"('warren', 'just')",1,226,9.320620007642909e-06,0.004475779300510952,227
"('kill', 'officer')",226,1,0.002106460121727297,1.9804333188101555e-05,227
"('boston', 'university🤔🤔🤔🤔🤔wednesdaythoughts')",226,1,0.002106460121727297,1.9804333188101555e-05,227
"('newly', 'disclosed')",1,225,9.320620007642909e-06,0.00445597496732285,226
"('judge', 'jeanine')",225,1,0.0020971395017196546,1.9804333188101555e-05,226
"('alveda', 'king')",225,1,0.0020971395017196546,1.9804333188101555e-05,226
"('in', 'newly')",1,225,9.320620007642909e-06,0.00445597496732285,226
"('israel', 'via')",225,1,0.0020971395017196546,1.9804333188101555e-05,226
"('the', 'phillies')",224,1,0.0020878188817120115,1.9804333188101555e-05,225
"('three', 'time')",224,1,0.0020878188817120115,1.9804333188101555e-05,225
"('to', 'me')",169,56,0.0015751847812916515,0.0011090426585336872,225
"('the', 'endangered')",1,224,9.320620007642909e-06,0.004436170634134749,225
"('be', 'stopped')",223,2,0.0020784982617043685,3.960866637620311e-05,225
"('california', 'three')",223,1,0.0020784982617043685,1.9804333188101555e-05,224
"('have', 'come')",220,4,0.00205053640168144,7.921733275240622e-05,224
"('over', 'ukraine')",1,223,9.320620007642909e-06,0.0044163663009466475,224
"('trump', 'by')",1,223,9.320620007642909e-06,0.0044163663009466475,224
"('syria', 'falls')",222,1,0.002069177641696726,1.9804333188101555e-05,223
"('frustrates', 'democrats')",1,222,9.320620007642909e-06,0.004396561967758545,223
"('administration', 'to')",1,222,9.320620007642909e-06,0.004396561967758545,223
"('oscars', 'straight')",222,1,0.002069177641696726,1.9804333188101555e-05,223
"('momoa', 'clearly')",222,1,0.002069177641696726,1.9804333188101555e-05,223
"('clearly', 'came')",222,1,0.002069177641696726,1.9804333188101555e-05,223
"('from', 'work')",222,1,0.002069177641696726,1.9804333188101555e-05,223
"('jason', 'momoa')",222,1,0.002069177641696726,1.9804333188101555e-05,223
"('should', 'have')",17,206,0.00015845054012992945,0.00407969263674892,223
"('to', 'oscars')",222,1,0.002069177641696726,1.9804333188101555e-05,223
"('jeanine', 'calls')",221,1,0.002059857021689083,1.9804333188101555e-05,222
"('put', 'trump')",221,1,0.002059857021689083,1.9804333188101555e-05,222
"('work', 'oscars')",221,1,0.002059857021689083,1.9804333188101555e-05,222
"('biden', 'of')",221,1,0.002059857021689083,1.9804333188101555e-05,222
"('statement', 'for')",1,221,9.320620007642909e-06,0.004376757634570444,222
"('of', 'state')",3,219,2.7961860022928726e-05,0.004337148968194241,222
"('position', 'and')",213,8,0.0019852920616279393,0.00015843466550481244,221
"('as', 'impeachment')",1,220,9.320620007642909e-06,0.004356953301382342,221
"('access', 'to')",33,188,0.00030758046025221596,0.0037232146393630927,221
"('in', 'alabama')",219,1,0.0020412157816737967,1.9804333188101555e-05,220
"('picture', 'of')",218,2,0.002031895161666154,3.960866637620311e-05,220
"('the', 'way')",24,196,0.0002236948801834298,0.0038816493048679053,220
"('get', 'a')",63,157,0.0005871990604815032,0.003109280310531944,220
"('stock', 'broker')",218,1,0.002031895161666154,1.9804333188101555e-05,219
"('it', 'and')",184,35,0.0017149940814062952,0.0006931516615835545,219
"('worried', 'stock')",218,1,0.002031895161666154,1.9804333188101555e-05,219
"('broker', 'staring')",218,1,0.002031895161666154,1.9804333188101555e-05,219
"('over', 'picture')",218,1,0.002031895161666154,1.9804333188101555e-05,219
"('staring', 'at')",218,1,0.002031895161666154,1.9804333188101555e-05,219
"('democrats', 'as')",1,218,9.320620007642909e-06,0.0043173446350061396,219
"('probe', 'hearing')",1,218,9.320620007642909e-06,0.0043173446350061396,219
"('two', 'more')",215,4,0.0020039333016432254,7.921733275240622e-05,219
"('of', 'worried')",218,1,0.002031895161666154,1.9804333188101555e-05,219
"('money', 'vowing')",1,217,9.320620007642909e-06,0.0042975403018180374,218
"('600', 'points')",217,1,0.002022574541658511,1.9804333188101555e-05,218
"('drops', '600')",217,1,0.002022574541658511,1.9804333188101555e-05,218
"('stop', 'impeachment')",1,217,9.320620007642909e-06,0.0042975403018180374,218
"('dow', 'drops')",217,1,0.002022574541658511,1.9804333188101555e-05,218
"('see', 'this')",215,3,0.0020039333016432254,5.941299956430467e-05,218
"('points', 'over')",217,1,0.002022574541658511,1.9804333188101555e-05,218
"('in', 'any')",213,5,0.0019852920616279393,9.902166594050779e-05,218
"('mcconnell', 'raises')",1,217,9.320620007642909e-06,0.0042975403018180374,218
"('raises', 'money')",1,217,9.320620007642909e-06,0.0042975403018180374,218
"('computer', 'screen')",217,1,0.002022574541658511,1.9804333188101555e-05,218
"('has', 'received')",1,217,9.320620007642909e-06,0.0042975403018180374,218
"('said', 'it')",4,214,3.7282480030571634e-05,0.004238127302253733,218
"('at', 'computer')",217,1,0.002022574541658511,1.9804333188101555e-05,218
"('host', 'were')",216,1,0.002013253921650868,1.9804333188101555e-05,217
"('president', 'to')",1,216,9.320620007642909e-06,0.004277735968629936,217
"('and', 'italy')",215,2,0.0020039333016432254,3.960866637620311e-05,217
"('our', 'country')",54,163,0.000503313480412717,0.003228106309660554,217
"('for', 'child')",21,196,0.00019573302016050108,0.0038816493048679053,217
"('in', 'big')",204,13,0.0019014064815591532,0.00025745633144532023,217
"('report', 'fbi')",216,1,0.002013253921650868,1.9804333188101555e-05,217
"('have', 'all')",216,1,0.002013253921650868,1.9804333188101555e-05,217
"('have', 'proved')",215,1,0.0020039333016432254,1.9804333188101555e-05,216
"('hungary', 'and')",215,1,0.0020039333016432254,1.9804333188101555e-05,216
"('italy', 'have')",215,1,0.0020039333016432254,1.9804333188101555e-05,216
"('to', 'end')",87,129,0.000810893940664933,0.0025547589812651007,216
"('gun', 'control')",147,69,0.0013701311411235075,0.0013664989899790075,216
"('impeaching', 'trump')",1,215,9.320620007642909e-06,0.004257931635441835,216
"('throw', 'in')",215,1,0.0020039333016432254,1.9804333188101555e-05,216
"('migration', 'can')",215,1,0.0020039333016432254,1.9804333188101555e-05,216
"('maga', 'hats')",215,1,0.0020039333016432254,1.9804333188101555e-05,216
"('news', 'media')",204,12,0.0019014064815591532,0.0002376519982572187,216
"('orban', 'hungary')",215,1,0.0020039333016432254,1.9804333188101555e-05,216
"('immigration', 'for')",215,1,0.0020039333016432254,1.9804333188101555e-05,216
"('the', 'ocean')",121,94,0.0011277950209247919,0.0018616073196815464,215
"('more', 'women')",214,1,0.0019946126816355824,1.9804333188101555e-05,215
"('im', 'really')",213,2,0.0019852920616279393,3.960866637620311e-05,215
"('accuse', 'former')",214,1,0.0019946126816355824,1.9804333188101555e-05,215
"('any', 'way')",214,1,0.0019946126816355824,1.9804333188101555e-05,215
"('small', 'town')",213,2,0.0019852920616279393,3.960866637620311e-05,215
"('a', 'republican')",3,212,2.7961860022928726e-05,0.00419851863587753,215
"('feels', 'like')",214,1,0.0019946126816355824,1.9804333188101555e-05,215
"('of', 'inappropriately')",214,1,0.0019946126816355824,1.9804333188101555e-05,215
"('inappropriately', 'touching')",214,1,0.0019946126816355824,1.9804333188101555e-05,215
"('touching', 'them')",214,1,0.0019946126816355824,1.9804333188101555e-05,215
"('trump', 'told')",1,214,9.320620007642909e-06,0.004238127302253733,215
"('and', 'was')",7,207,6.524434005350036e-05,0.004099496969937022,214
"('best', 'position')",213,1,0.0019852920616279393,1.9804333188101555e-05,214
"('to', 'allow')",117,97,0.0010905125408942203,0.001921020319245851,214
"('fact', 'check')",3,211,2.7961860022928726e-05,0.004178714302689428,214
"('phillies', 'have')",213,1,0.0019852920616279393,1.9804333188101555e-05,214
"('have', 'to')",138,76,0.0012862455610547214,0.0015051293222957183,214
"('ever', 'thought')",213,1,0.0019852920616279393,1.9804333188101555e-05,214
"('it', 'feels')",213,1,0.0019852920616279393,1.9804333188101555e-05,214
"('proved', 'illegal')",213,1,0.0019852920616279393,1.9804333188101555e-05,214
"('myself', 'in')",213,1,0.0019852920616279393,1.9804333188101555e-05,214
"('put', 'myself')",213,1,0.0019852920616279393,1.9804333188101555e-05,214
"('really', 'trying')",213,1,0.0019852920616279393,1.9804333188101555e-05,214
"('thought', 'bradley')",212,1,0.0019759714416202967,1.9804333188101555e-05,213
"('our', 'troops')",44,169,0.000410107280336288,0.003346932308789163,213
"('she', 'ever')",212,1,0.0019759714416202967,1.9804333188101555e-05,213
"('gaga', 'quashes')",212,1,0.0019759714416202967,1.9804333188101555e-05,213
"('camp', 'in')",212,1,0.0019759714416202967,1.9804333188101555e-05,213
"('lady', 'gaga')",212,1,0.0019759714416202967,1.9804333188101555e-05,213
"('cooper', 'talented')",212,1,0.0019759714416202967,1.9804333188101555e-05,213
"('talented', 'in')",212,1,0.0019759714416202967,1.9804333188101555e-05,213
"('quashes', 'rumors')",212,1,0.0019759714416202967,1.9804333188101555e-05,213
"('rumors', 'that')",212,1,0.0019759714416202967,1.9804333188101555e-05,213
"('the', 'pieces')",212,1,0.0019759714416202967,1.9804333188101555e-05,213
"('pieces', 'in')",212,1,0.0019759714416202967,1.9804333188101555e-05,213
"('in', 'pl')",211,1,0.0019666508216126537,1.9804333188101555e-05,212
"('40', 'years')",211,1,0.0019666508216126537,1.9804333188101555e-05,212
"('illegal', 'mass')",211,1,0.0019666508216126537,1.9804333188101555e-05,212
"('president', 'donald')",16,196,0.00014912992012228654,0.0038816493048679053,212
"('is', 'going')",137,75,0.0012769249410470784,0.0014853249891076167,212
"('green', 'cards')",164,48,0.001528581681253437,0.0009506079930288747,212
"('mass', 'migration')",211,1,0.0019666508216126537,1.9804333188101555e-05,212
"('all', 'legal')",211,1,0.0019666508216126537,1.9804333188101555e-05,212
"('the', 'only')",30,182,0.00027961860022928726,0.0036043886402344835,212
"('who', 'are')",42,170,0.00039146604032100216,0.0033667366419772647,212
"('drafted', 'a')",1,211,9.320620007642909e-06,0.004178714302689428,212
"('is', 'our')",189,23,0.0017615971814445098,0.0004554996633263358,212
"('us', 'workforce')",210,1,0.0019573302016050106,1.9804333188101555e-05,211
"('not', 'the')",134,77,0.0012489630810241497,0.0015249336554838198,211
"('fight', 'against')",125,86,0.0011650775009553636,0.0017031726541767338,211
"('maintains', 'us')",210,1,0.0019573302016050106,1.9804333188101555e-05,211
"('years', 'maintains')",210,1,0.0019573302016050106,1.9804333188101555e-05,211
"('for', 'wearing')",210,1,0.0019573302016050106,1.9804333188101555e-05,211
"('for', '40')",210,1,0.0019573302016050106,1.9804333188101555e-05,211
"('study', 'ending')",210,1,0.0019573302016050106,1.9804333188101555e-05,211
"('the', 'nra')",4,207,3.7282480030571634e-05,0.004099496969937022,211
"('ending', 'all')",210,1,0.0019573302016050106,1.9804333188101555e-05,211
"('great', 'news')",3,207,2.7961860022928726e-05,0.004099496969937022,210
"('is', 'what')",61,149,0.0005685578204662175,0.002950845645027132,210
"('the', 'american')",139,71,0.0012955661810623643,0.0014061076563552106,210
"('stupid', 'and')",206,4,0.0019200477215744391,7.921733275240622e-05,210
"('thinks', 'youre')",206,4,0.0019200477215744391,7.921733275240622e-05,210
"('being', 'a')",156,54,0.0014540167211922936,0.001069433992157484,210
"('go', 'to')",148,62,0.0013794517611311504,0.0012278686576622966,210
"('impeachment', 'cnnpolitics')",1,209,9.320620007642909e-06,0.004139105636313226,210
"('at', 'his')",1,208,9.320620007642909e-06,0.004119301303125124,209
"('people', 'who')",126,83,0.0011743981209630064,0.0016437596546124292,209
"('about', 'immigration')",163,46,0.001519261061245794,0.0009109993266526716,209
"('trade', 'war')",178,31,0.0016590703613604378,0.0006139343288311483,209
"('president', 'this')",4,205,3.7282480030571634e-05,0.004059888303560819,209
"('it', 'when')",199,10,0.0018548033815209387,0.00019804333188101558,209
"('and', 'a')",21,188,0.00019573302016050108,0.0037232146393630927,209
"('alone', 'is')",2,206,1.8641240015285817e-05,0.00407969263674892,208
"('whos', 'been')",190,18,0.0017709178014521526,0.000356477997385828,208
"('or', 'the')",32,176,0.0002982598402445731,0.003485562641105874,208
"('google', 'thinks')",207,1,0.001929368341582082,1.9804333188101555e-05,208
"('has', 'nothing')",2,206,1.8641240015285817e-05,0.00407969263674892,208
"('signed', 'into')",3,205,2.7961860022928726e-05,0.004059888303560819,208
"('we', 'can')",81,127,0.0007549702206190756,0.002515150314888898,208
"('into', 'law')",3,205,2.7961860022928726e-05,0.004059888303560819,208
"('would', 'have')",88,120,0.000820214560672576,0.002376519982572187,208
"('must', 'tell')",206,1,0.0019200477215744391,1.9804333188101555e-05,207
"('vote', 'breakthemup')",206,1,0.0019200477215744391,1.9804333188101555e-05,207
"('was', 'signed')",1,206,9.320620007642909e-06,0.00407969263674892,207
"('you', 'how')",206,1,0.0019200477215744391,1.9804333188101555e-05,207
"('youre', 'stupid')",206,1,0.0019200477215744391,1.9804333188101555e-05,207
"('bald', 'eagle')",1,206,9.320620007642909e-06,0.00407969263674892,207
"('the', 'bald')",1,206,9.320620007642909e-06,0.00407969263674892,207
"('saved', 'the')",1,206,9.320620007642909e-06,0.00407969263674892,207
"('we', 'all')",178,29,0.0016590703613604378,0.0005743256624549452,207
"('information', 'about')",4,203,3.7282480030571634e-05,0.004020279637184616,207
"('trumps', 'dealings')",1,205,9.320620007642909e-06,0.004059888303560819,206
"('eagle', 'and')",1,205,9.320620007642909e-06,0.004059888303560819,206
"('the', 'little')",201,5,0.0018734446215362245,9.902166594050779e-05,206
"('republican', 'president')",1,205,9.320620007642909e-06,0.004059888303560819,206
"('act', 'saved')",1,205,9.320620007642909e-06,0.004059888303560819,206
"('a', 'job')",205,1,0.0019107271015667963,1.9804333188101555e-05,206
"('ukraine', 'is')",1,205,9.320620007642909e-06,0.004059888303560819,206
"('mike', 'pence')",1,205,9.320620007642909e-06,0.004059888303560819,206
"('hate', 'crime')",203,2,0.0018920858615515104,3.960866637620311e-05,205
"('news', 'second')",1,204,9.320620007642909e-06,0.004040083970372718,205
"('town', 'billionaire')",203,1,0.0018920858615515104,1.9804333188101555e-05,204
"('billionaire', 'fails')",203,1,0.0018920858615515104,1.9804333188101555e-05,204
"('big', 'city')",203,1,0.0018920858615515104,1.9804333188101555e-05,204
"('ilhan', 'omar')",142,61,0.001323528041085293,0.001208064324474195,203
"('mainstream', 'fake')",199,4,0.0018548033815209387,7.921733275240622e-05,203
"('promises', 'made')",200,3,0.0018641240015285817,5.941299956430467e-05,203
"('a', 'pretty')",193,10,0.0017988796614750813,0.00019804333188101558,203
"('with', 'russia')",193,10,0.0017988796614750813,0.00019804333188101558,203
"('made', 'promises')",200,3,0.0018641240015285817,5.941299956430467e-05,203
"('the', 'left')",166,37,0.0015472229212687228,0.0007327603279597576,203
"('maga', 'hat')",201,1,0.0018734446215362245,1.9804333188101555e-05,202
"('state', 'sen')",1,201,9.320620007642909e-06,0.003980670970808413,202
"('dearborn', 'and')",1,201,9.320620007642909e-06,0.003980670970808413,202
"('silence', 'on')",1,201,9.320620007642909e-06,0.003980670970808413,202
"('the', 'nation')",166,36,0.0015472229212687228,0.000712955994771656,202
"('trade', 'talks')",1,201,9.320620007642909e-06,0.003980670970808413,202
"('body', 'parts')",201,1,0.0018734446215362245,1.9804333188101555e-05,202
"('the', 'hell')",151,51,0.001407413621154079,0.0010100209925931795,202
"('youre', 'not')",100,102,0.0009320620007642909,0.002020041985186359,202
"('front', 'of')",166,35,0.0015472229212687228,0.0006931516615835545,201
"('protests', 'as')",1,200,9.320620007642909e-06,0.003960866637620311,201
"('michael', 'folmer')",1,200,9.320620007642909e-06,0.003960866637620311,201
"('sen', 'michael')",1,200,9.320620007642909e-06,0.003960866637620311,201
"('as', 'trade')",1,200,9.320620007642909e-06,0.003960866637620311,201
"('promises', 'kept👇👇report')",200,1,0.0018641240015285817,1.9804333188101555e-05,201
"('on', 'record')",200,1,0.0018641240015285817,1.9804333188101555e-05,201
"('promised', 'xi')",1,200,9.320620007642909e-06,0.003960866637620311,201
"('in', '2020')",135,66,0.0012582837010317927,0.0013070859904147027,201
"('snakes', 'or')",1,200,9.320620007642909e-06,0.003960866637620311,201
"('in', 'london')",199,2,0.0018548033815209387,3.960866637620311e-05,201
"('love', 'it')",114,87,0.0010625506808712916,0.0017229769873648355,201
"('fourth', 'hottest')",200,1,0.0018641240015285817,1.9804333188101555e-05,201
"('trump', '‘')",23,178,0.0002143742601757869,0.0035251713074820772,201
"('covered', 'by')",199,2,0.0018548033815209387,3.960866637620311e-05,201
"('hottest', 'year')",200,1,0.0018641240015285817,1.9804333188101555e-05,201
"('kept👇👇report', 'final')",200,1,0.0018641240015285817,1.9804333188101555e-05,201
"('2018', 'fourth')",200,1,0.0018641240015285817,1.9804333188101555e-05,201
"('year', 'on')",200,1,0.0018641240015285817,1.9804333188101555e-05,201
"('on', 'hong')",1,200,9.320620007642909e-06,0.003960866637620311,201
"('if', 'the')",55,146,0.00051263410042036,0.002891432645462827,201
"('kong', 'democracy')",1,200,9.320620007642909e-06,0.003960866637620311,201
"('democracy', 'protests')",1,200,9.320620007642909e-06,0.003960866637620311,201
"('the', 'police')",200,1,0.0018641240015285817,1.9804333188101555e-05,201
"('who', 'attacked')",200,1,0.0018641240015285817,1.9804333188101555e-05,201
"('western', 'clothes')",199,1,0.0018548033815209387,1.9804333188101555e-05,200
"('clothes', 'police')",199,1,0.0018548033815209387,1.9804333188101555e-05,200
"('police', 'urge')",199,1,0.0018548033815209387,1.9804333188101555e-05,200
"('of', 'thousands')",191,9,0.0017802384214597954,0.000178238998692914,200
"('urge', 'more')",199,1,0.0018548033815209387,1.9804333188101555e-05,200
"('more', 'victims')",199,1,0.0018548033815209387,1.9804333188101555e-05,200
"('victims', 'to')",199,1,0.0018548033815209387,1.9804333188101555e-05,200
"('attacked', 'family')",199,1,0.0018548033815209387,1.9804333188101555e-05,200
"('left', 'stalker')",199,1,0.0018548033815209387,1.9804333188101555e-05,200
"('prime', 'minister')",9,191,8.388558006878618e-05,0.0037826276389273973,200
"('moscow', 'mitchhe')",1,199,9.320620007642909e-06,0.00394106230443221,200
"('mitchhe', 'needs')",1,199,9.320620007642909e-06,0.00394106230443221,200
"('to', 'gomitch')",1,199,9.320620007642909e-06,0.00394106230443221,200
"('gomitch', 'mcconnell')",1,199,9.320620007642909e-06,0.00394106230443221,200
"('quite', 'the')",196,4,0.00182684152149801,7.921733275240622e-05,200
"('stalker', 'who')",199,1,0.0018548033815209387,1.9804333188101555e-05,200
"('news', 'that')",7,193,6.524434005350036e-05,0.0038222363053036002,200
"('wont', 'see')",199,1,0.0018548033815209387,1.9804333188101555e-05,200
"('and', 'porter')",1,199,9.320620007642909e-06,0.00394106230443221,200
"('story', 'covered')",199,1,0.0018548033815209387,1.9804333188101555e-05,200
"('xi', 'us')",1,199,9.320620007642909e-06,0.00394106230443221,200
"('us', 'silence')",1,199,9.320620007642909e-06,0.00394106230443221,200
"('folmer', 'arrested')",1,199,9.320620007642909e-06,0.00394106230443221,200
"('if', 'democrats')",40,160,0.00037282480030571634,0.0031686933100962492,200
"('london', 'woman')",199,1,0.0018548033815209387,1.9804333188101555e-05,200
"('been', 'in')",194,6,0.0018082002814827243,0.00011882599912860934,200
"('woman', 'threatened')",199,1,0.0018548033815209387,1.9804333188101555e-05,200
"('threatened', 'for')",199,1,0.0018548033815209387,1.9804333188101555e-05,200
"('wearing', '‘')",199,1,0.0018548033815209387,1.9804333188101555e-05,200
"('talks', 'stalled')",1,199,9.320620007642909e-06,0.00394106230443221,200
"('‘', 'western')",199,1,0.0018548033815209387,1.9804333188101555e-05,200
"('what', 'is')",125,75,0.0011650775009553636,0.0014853249891076167,200
"('kids', '”')",198,1,0.0018454827615132958,1.9804333188101555e-05,199
"('pride', 'kids')",198,1,0.0018454827615132958,1.9804333188101555e-05,199
"('why', 'is')",165,34,0.00153790230126108,0.0006733473283954529,199
"('your', 'maga')",198,1,0.0018454827615132958,1.9804333188101555e-05,199
"('womens', 'rights')",198,1,0.0018454827615132958,1.9804333188101555e-05,199
"('”', 'writes')",198,1,0.0018454827615132958,1.9804333188101555e-05,199
"('wear', 'your')",198,1,0.0018454827615132958,1.9804333188101555e-05,199
"('hats', 'with')",198,1,0.0018454827615132958,1.9804333188101555e-05,199
"('writes', 'for')",198,1,0.0018454827615132958,1.9804333188101555e-05,199
"('with', 'pride')",198,1,0.0018454827615132958,1.9804333188101555e-05,199
"('is', 'on')",58,140,0.0005405959604432886,0.002772606646334218,198
"('trump', 'doesnt')",168,30,0.0015658641612840086,0.0005941299956430467,198
"('levin', '‘')",197,1,0.001836162141505653,1.9804333188101555e-05,198
"('record', 'whatdoyouthink')",197,1,0.001836162141505653,1.9804333188101555e-05,198
"('gop', 'senators')",1,197,9.320620007642909e-06,0.0039014536380560065,198
"('his', 'white')",2,196,1.8641240015285817e-05,0.0038816493048679053,198
"('call', 'with')",1,197,9.320620007642909e-06,0.0039014536380560065,198
"('intelligence', 'official')",1,197,9.320620007642909e-06,0.0039014536380560065,198
"('pretty', 'good')",190,7,0.0017709178014521526,0.0001386303323167109,197
"('gets', 'to')",196,1,0.00182684152149801,1.9804333188101555e-05,197
"('‘', 'delighted')",196,1,0.00182684152149801,1.9804333188101555e-05,197
"('trump', 'restricted')",196,1,0.00182684152149801,1.9804333188101555e-05,197
"('delighted', 'trump')",196,1,0.00182684152149801,1.9804333188101555e-05,197
"('elder', 'daughter')",1,196,9.320620007642909e-06,0.0038816493048679053,197
"('trumps', 'elder')",1,196,9.320620007642909e-06,0.0038816493048679053,197
"('back', 'on')",32,165,0.0002982598402445731,0.0032677149760367567,197
"('restricted', 'funding')",196,1,0.00182684152149801,1.9804333188101555e-05,197
"('million', 'in')",177,20,0.0016497497413527947,0.00039608666376203115,197
"('to', 'planned')",196,1,0.00182684152149801,1.9804333188101555e-05,197
"('broken', 'my')",196,1,0.00182684152149801,1.9804333188101555e-05,197
"('ny', 'times')",154,43,0.001435375481177008,0.0008515863270883669,197
"('princess', 'is')",195,1,0.0018175209014903672,1.9804333188101555e-05,196
"('ivanka', 'a')",1,195,9.320620007642909e-06,0.0038618449716798036,196
"('he', 'gets')",193,3,0.0017988796614750813,5.941299956430467e-05,196
"('it', 'will')",32,164,0.0002982598402445731,0.003247910642848655,196
"('house', 'staff')",1,195,9.320620007642909e-06,0.0038618449716798036,196
"('little', 'capitalist')",195,1,0.0018175209014903672,1.9804333188101555e-05,196
"('socialism', 'princess')",195,1,0.0018175209014903672,1.9804333188101555e-05,196
"('the', 'socialism')",195,1,0.0018175209014903672,1.9804333188101555e-05,196
"('capitalist', '😏93trilliongreennewdisaster')",195,1,0.0018175209014903672,1.9804333188101555e-05,196
"('didnt', 'have')",10,186,9.320620007642909e-05,0.0036836059729868894,196
"('is', 'quite')",195,1,0.0018175209014903672,1.9804333188101555e-05,196
"('found', 'in')",193,2,0.0017988796614750813,3.960866637620311e-05,195
"('the', 'rubes')",194,1,0.0018082002814827243,1.9804333188101555e-05,195
"('staff', 'has')",1,194,9.320620007642909e-06,0.003842040638491702,195
"('job', 'in')",194,1,0.0018082002814827243,1.9804333188101555e-05,195
"('adviser', 'on')",1,194,9.320620007642909e-06,0.003842040638491702,195
"('baby', 'body')",194,1,0.0018082002814827243,1.9804333188101555e-05,195
"('daughter', 'ivanka')",1,194,9.320620007642909e-06,0.003842040638491702,195
"('was', 'in')",122,73,0.001137115640932435,0.0014457163227314135,195
"('build', 'the')",188,7,0.0017522765614368667,0.0001386303323167109,195
"('senior', 'adviser')",1,194,9.320620007642909e-06,0.003842040638491702,195
"('nhl', 'ref')",193,1,0.0017988796614750813,1.9804333188101555e-05,194
"('ref', 'likes')",193,1,0.0017988796614750813,1.9804333188101555e-05,194
"('likes', 'it')",193,1,0.0017988796614750813,1.9804333188101555e-05,194
"('bill', 'to')",163,31,0.001519261061245794,0.0006139343288311483,194
"('with', 'my')",3,191,2.7961860022928726e-05,0.0037826276389273973,194
"('jump', 'over')",193,1,0.0017988796614750813,1.9804333188101555e-05,194
"('received', 'trademarks')",1,193,9.320620007642909e-06,0.0038222363053036002,194
"('tens', 'of')",193,1,0.0017988796614750813,1.9804333188101555e-05,194
"('king', '‘')",193,1,0.0017988796614750813,1.9804333188101555e-05,194
"('trademarks', 'from')",1,193,9.320620007642909e-06,0.0038222363053036002,194
"('the', 'welfare')",184,10,0.0017149940814062952,0.00019804333188101558,194
"('even', 'afte')",1,193,9.320620007642909e-06,0.0038222363053036002,194
"('china', 'even')",1,193,9.320620007642909e-06,0.0038222363053036002,194
"('account', 'of')",1,192,9.320620007642909e-06,0.003802431972115499,193
"('impeach', 'trump')",1,192,9.320620007642909e-06,0.003802431972115499,193
"('in', 'august')",1,192,9.320620007642909e-06,0.003802431972115499,193
"('by', '45')",1,192,9.320620007642909e-06,0.003802431972115499,193
"('welfare', 'of')",183,10,0.0017056734613986521,0.00019804333188101558,193
"('was', 'white')",192,1,0.0017895590414674385,1.9804333188101555e-05,193
"('use', 'of')",149,44,0.0013887723811387934,0.0008713906602764685,193
"('has', 'no')",118,75,0.0010998331609018632,0.0014853249891076167,193
"('phone', 'call')",2,191,1.8641240015285817e-05,0.0037826276389273973,193
"('over', 'puck')",192,1,0.0017895590414674385,1.9804333188101555e-05,193
"('any', 'other')",165,28,0.00153790230126108,0.0005545213292668436,193
"('sweet', 'justice')",192,1,0.0017895590414674385,1.9804333188101555e-05,193
"('thank', 'you')",149,44,0.0013887723811387934,0.0008713906602764685,193
"('white', 'and')",191,2,0.0017802384214597954,3.960866637620311e-05,193
"('tell', 'me')",180,13,0.0016777116013757234,0.00025745633144532023,193
"('from', 'syria')",18,174,0.00016777116013757235,0.003445953974729671,192
"('police', 'force')",191,1,0.0017802384214597954,1.9804333188101555e-05,192
"('against', 'the')",15,177,0.00013980930011464363,0.0035053669742939756,192
"('text', 'messages')",1,191,9.320620007642909e-06,0.0037826276389273973,192
"('50', 'shot')",191,1,0.0017802384214597954,1.9804333188101555e-05,192
"('justice', 'man')",191,1,0.0017802384214597954,1.9804333188101555e-05,192
"('bitter', 'sweet')",191,1,0.0017802384214597954,1.9804333188101555e-05,192
"('scoop', 'trump')",1,191,9.320620007642909e-06,0.0037826276389273973,192
"('was', 'refused')",191,1,0.0017802384214597954,1.9804333188101555e-05,192
"('shot', '10')",191,1,0.0017802384214597954,1.9804333188101555e-05,192
"('10', 'killed')",191,1,0.0017802384214597954,1.9804333188101555e-05,192
"('refused', 'a')",191,1,0.0017802384214597954,1.9804333188101555e-05,192
"('wins', 'appealht')",191,1,0.0017802384214597954,1.9804333188101555e-05,192
"('straight', 'wins')",191,1,0.0017802384214597954,1.9804333188101555e-05,192
"('she', 'has')",151,41,0.001407413621154079,0.0008119776607121638,192
"('jobs', 'to')",186,6,0.001733635321421581,0.00011882599912860934,192
"('force', 'because')",191,1,0.0017802384214597954,1.9804333188101555e-05,192
"('they', 'want')",166,26,0.0015472229212687228,0.0005149126628906405,192
"('and', 'straight')",191,1,0.0017802384214597954,1.9804333188101555e-05,192
"('call', 'the')",2,189,1.8641240015285817e-05,0.0037430189725511944,191
"('foreign', 'nationals')",190,1,0.0017709178014521526,1.9804333188101555e-05,191
"('man', 'whos')",190,1,0.0017709178014521526,1.9804333188101555e-05,191
"('than', 'any')",160,31,0.0014912992012228654,0.0006139343288311483,191
"('hed', 'be')",190,1,0.0017709178014521526,1.9804333188101555e-05,191
"('us', 'is')",182,9,0.0016963528413910093,0.000178238998692914,191
"('gun', 'violence')",2,188,1.8641240015285817e-05,0.0037232146393630927,190
"('and', 'china')",143,47,0.0013328486610929358,0.0009308036598407732,190
"('good', 'architect')",189,1,0.0017615971814445098,1.9804333188101555e-05,190
"('decline', 'of')",188,2,0.0017522765614368667,3.960866637620311e-05,190
"('or', 'alligators')",1,189,9.320620007642909e-06,0.0037430189725511944,190
"('news', 'confirms')",1,189,9.320620007642909e-06,0.0037430189725511944,190
"('of', 'buildings')",189,1,0.0017615971814445098,1.9804333188101555e-05,190
"('i', 'was')",75,114,0.0006990465005732181,0.0022576939834435773,189
"('media', 'blackout')",188,1,0.0017522765614368667,1.9804333188101555e-05,189
"('american', 'media')",187,2,0.0017429559414292239,3.960866637620311e-05,189
"('health', 'and')",177,12,0.0016497497413527947,0.0002376519982572187,189
"('check', 'trump')",1,188,9.320620007642909e-06,0.0037232146393630927,189
"('destroyed', 'tens')",188,1,0.0017522765614368667,1.9804333188101555e-05,189
"('avert', 'global')",188,1,0.0017522765614368667,1.9804333188101555e-05,189
"('with', 'this')",99,90,0.0009227413807566479,0.00178238998692914,189
"('national', 'archive')",188,1,0.0017522765614368667,1.9804333188101555e-05,189
"('the', 'russians')",5,184,4.660310003821454e-05,0.0036439973066106864,189
"('global', 'decline')",188,1,0.0017522765614368667,1.9804333188101555e-05,189
"('buildings', 'figures')",188,1,0.0017522765614368667,1.9804333188101555e-05,189
"('seed', 'based')",188,1,0.0017522765614368667,1.9804333188101555e-05,189
"('of', 'insects')",188,1,0.0017522765614368667,1.9804333188101555e-05,189
"('zelensky', 'in')",1,188,9.320620007642909e-06,0.0037232146393630927,189
"('insects', 'by')",188,1,0.0017522765614368667,1.9804333188101555e-05,189
"('by', 'adopting')",188,1,0.0017522765614368667,1.9804333188101555e-05,189
"('adopting', 'seed')",188,1,0.0017522765614368667,1.9804333188101555e-05,189
"('urge', 'birds')",188,1,0.0017522765614368667,1.9804333188101555e-05,189
"('like', 'it')",6,183,5.592372004585745e-05,0.0036241929734225848,189
"('birds', 'to')",188,1,0.0017522765614368667,1.9804333188101555e-05,189
"('to', 'avert')",188,1,0.0017522765614368667,1.9804333188101555e-05,189
"('figures', 'hed')",188,1,0.0017522765614368667,1.9804333188101555e-05,189
"('call', 'to')",39,149,0.0003635041802980734,0.002950845645027132,188
"('archive', 'records')",187,1,0.0017429559414292239,1.9804333188101555e-05,188
"('promise', 'to')",154,34,0.001435375481177008,0.0006733473283954529,188
"('my', 'colleagues')",1,187,9.320620007642909e-06,0.003703410306174991,188
"('democrats', 'in')",2,186,1.8641240015285817e-05,0.0036836059729868894,188
"('the', 'legs')",1,187,9.320620007642909e-06,0.003703410306174991,188
"('obama', 'destroyed')",187,1,0.0017429559414292239,1.9804333188101555e-05,188
"('connection', 'to')",155,33,0.0014446961011846508,0.0006535429952073513,188
"('ecologists', 'urge')",187,1,0.0017429559414292239,1.9804333188101555e-05,188
"('blackout', 'obama')",187,1,0.0017429559414292239,1.9804333188101555e-05,188
"('parts', 'in')",186,1,0.001733635321421581,1.9804333188101555e-05,187
"('deal', 'to')",1,186,9.320620007642909e-06,0.0036836059729868894,187
"('that', 'sucks')",186,1,0.001733635321421581,1.9804333188101555e-05,187
"('the', 'same')",53,134,0.0004939928604050742,0.0026537806472056087,187
"('stalled', 'with')",1,186,9.320620007642909e-06,0.0036836059729868894,187
"('rudy', 'giuliani')",42,145,0.00039146604032100216,0.002871628312274726,187
"('manufacturing', 'plants')",185,1,0.001724314701413938,1.9804333188101555e-05,186
"('colleagues', '\u2066')",1,185,9.320620007642909e-06,0.003663801639798788,186
"('ford', 'adding')",185,1,0.001724314701413938,1.9804333188101555e-05,186
"('adding', '500')",185,1,0.001724314701413938,1.9804333188101555e-05,186
"('human', 'trafficking')",185,1,0.001724314701413938,1.9804333188101555e-05,186
"('me', 'this')",175,11,0.0016311085013375089,0.00021784766506911712,186
"('to', 'foreigners')",185,1,0.001724314701413938,1.9804333188101555e-05,186
"('second', 'intelligence')",1,185,9.320620007642909e-06,0.003663801639798788,186
"('house', 'intel')",1,185,9.320620007642909e-06,0.003663801639798788,186
"('based', 'diet')",185,1,0.001724314701413938,1.9804333188101555e-05,186
"('off', 'on')",17,169,0.00015845054012992945,0.003346932308789163,186
"('500', 'american')",185,1,0.001724314701413938,1.9804333188101555e-05,186
"('native', 'born')",185,1,0.001724314701413938,1.9804333188101555e-05,186
"('to', 'chicago')",185,1,0.001724314701413938,1.9804333188101555e-05,186
"('chicago', 'manufacturing')",185,1,0.001724314701413938,1.9804333188101555e-05,186
"('trump', 'impeachment')",1,185,9.320620007642909e-06,0.003663801639798788,186
"('of', 'native')",184,1,0.0017149940814062952,1.9804333188101555e-05,185
"('trump', 'will')",4,181,3.7282480030571634e-05,0.003584584307046382,185
"('shocking', '🙄')",184,1,0.0017149940814062952,1.9804333188101555e-05,185
"('air', 'force')",1,184,9.320620007642909e-06,0.0036439973066106864,185
"('born', 'americans')",184,1,0.0017149940814062952,1.9804333188101555e-05,185
"('talking', 'about')",168,17,0.0015658641612840086,0.00033667366419772645,185
"('2x', 'the')",184,1,0.0017149940814062952,1.9804333188101555e-05,185
"('i', 'support')",4,181,3.7282480030571634e-05,0.003584584307046382,185
"('sucks', 'buildthatwall')",184,1,0.0017149940814062952,1.9804333188101555e-05,185
"('resistance', 'to')",2,183,1.8641240015285817e-05,0.0036241929734225848,185
"('‘', 'play')",184,1,0.0017149940814062952,1.9804333188101555e-05,185
"('nearly', '2x')",183,1,0.0017056734613986521,1.9804333188101555e-05,184
"('afraid', 'as')",1,183,9.320620007642909e-06,0.0036241929734225848,184
"('trump', 'wanted')",1,183,9.320620007642909e-06,0.0036241929734225848,184
"('these', 'people')",148,36,0.0013794517611311504,0.000712955994771656,184
"('as', 'ukraine')",1,183,9.320620007642909e-06,0.0036241929734225848,184
"('he', 'should')",166,18,0.0015472229212687228,0.000356477997385828,184
"('using', 'nearly')",183,1,0.0017056734613986521,1.9804333188101555e-05,184
"('and', 'afraid')",1,182,9.320620007642909e-06,0.0036043886402344835,183
"('angry', 'and')",1,182,9.320620007642909e-06,0.0036043886402344835,183
"('arrested', 'on')",182,1,0.0016963528413910093,1.9804333188101555e-05,183
"('the', 'british')",2,181,1.8641240015285817e-05,0.003584584307046382,183
"('who', 'gives')",181,2,0.0016870322213833665,3.960866637620311e-05,183
"('the', 'australian')",1,182,9.320620007642909e-06,0.0036043886402344835,183
"('whistleblower', 'wasnt')",1,182,9.320620007642909e-06,0.0036043886402344835,183
"('–', 'msnbc')",182,1,0.0016963528413910093,1.9804333188101555e-05,183
"('about', 'president')",1,181,9.320620007642909e-06,0.003584584307046382,182
"('dept', 'of')",177,5,0.0016497497413527947,9.902166594050779e-05,182
"('nolte', '–')",181,1,0.0016870322213833665,1.9804333188101555e-05,182
"('police', 'officer')",176,6,0.001640429121345152,0.00011882599912860934,182
"('on', 'fire')",181,1,0.0016870322213833665,1.9804333188101555e-05,182
"('this', 'would')",171,11,0.0015938260213069373,0.00021784766506911712,182
"('of', 'being')",173,9,0.0016124672613222232,0.000178238998692914,182
"('we', 'are')",87,95,0.000810893940664933,0.0018814116528696478,182
"('refusing', 'to')",1,180,9.320620007642909e-06,0.00356477997385828,181
"('the', 'latest')",16,165,0.00014912992012228654,0.0032677149760367567,181
"('el', 'paso')",2,179,1.8641240015285817e-05,0.0035449756406701785,181
