word,cnt_in_true,cnt_in_fake,freq_true,freq_fake,total_cnt
trump,8904,12574,0.08299080054805245,0.24901968550718898,21478
us,4488,2998,0.041830942594301375,0.059373390897928466,7486
illegal,5838,418,0.0544137796046193,0.008278211272626452,6256
gun,5770,432,0.05377997744409958,0.008555471937259872,6202
new,3162,2900,0.029471800464166878,0.05743256624549451,6062
ukraine,1,5785,9.320620007642909e-06,0.1145680674931675,5786
president,2101,3607,0.01958262263605775,0.07143422980948232,5708
news,3255,2279,0.03033861812487767,0.04513407533568345,5534
one,4341,790,0.04046081145317786,0.01564542321860023,5131
says,2489,2456,0.0231990231990232,0.048639442309977424,4945
trumps,988,3717,0.009208772567551194,0.07361270646017348,4705
via,2830,1415,0.02637735462162943,0.028023131461163704,4245
california,3641,376,0.03393637744782783,0.007446429278726185,4017
media,3366,548,0.03137320694572603,0.010852774587079653,3914
security,2960,851,0.027589035222623008,0.016853487543074426,3811
google,3773,22,0.03516669928883669,0.00043569533013823424,3795
brought,2265,1516,0.02111120431731119,0.03002336911316196,3781
house,652,3111,0.006077044244983176,0.06161128054818394,3763
time,1935,1822,0.018035399714789027,0.036083495068721036,3757
breitbart,3547,1,0.033060239167109394,1.9804333188101555e-05,3548
border,3041,503,0.028344005443242084,0.009961579593615082,3544
like,1912,1550,0.01782102545461324,0.03069671644155741,3462
take,2810,612,0.02619094222147657,0.012120251911118153,3422
child,3051,322,0.028437211643318513,0.006376995286568701,3373
visa,2729,566,0.025435972000857496,0.01120925258446548,3295
charged,3207,45,0.029891228364510806,0.00089119499346457,3252
alien,3238,4,0.030180167584747737,7.921733275240622e-05,3242
times,2570,671,0.023953993419642276,0.013288707569216145,3241
american,1313,1919,0.01223797407003514,0.03800451538796689,3232
anti,2978,216,0.027756806382760582,0.004277735968629936,3194
fake,2975,177,0.02772884452273765,0.0035053669742939756,3152
administration,1598,1530,0.014894350772213367,0.030300629777795383,3128
miss,3085,40,0.028754112723578373,0.0007921733275240623,3125
real,2478,631,0.023096496378939128,0.012496534241692081,3109
cnn,2823,242,0.02631211028157593,0.004792648631520576,3065
donald,2501,552,0.023310870639114915,0.01093199191983206,3053
school,2806,182,0.026153659741446,0.0036043886402344835,2988
super,2947,23,0.02746786716252365,0.0004554996633263358,2970
buildthewall,2958,1,0.027570393982607723,1.9804333188101555e-05,2959
bowl,2947,1,0.02746786716252365,1.9804333188101555e-05,2948
already,2175,707,0.020272348516623327,0.0140016635639878,2882
hollywood,2869,11,0.026740858801927503,0.00021784766506911712,2880
whistleblower,137,2709,0.0012769249410470784,0.05364993860656712,2846
mainstream,2427,415,0.022621144758549337,0.008218798273062145,2842
porn,2633,195,0.024541192480123777,0.0038618449716798036,2828
100,2802,11,0.02611637726141543,0.00021784766506911712,2813
shows,2313,461,0.02155859407767805,0.009129797599714818,2774
guards,2732,3,0.025463933860880427,5.941299956430467e-05,2735
armed,2709,8,0.02524955960070464,0.00015843466550481244,2717
away,2585,122,0.024093802719756918,0.00241612864894839,2707
surrounded,2688,9,0.02505382658054414,0.000178238998692914,2697
deportthemall,2693,1,0.02510042968058235,1.9804333188101555e-05,2694
would,1550,1131,0.014446961011846508,0.02239870083574286,2681
walls,2678,3,0.02496062038046771,5.941299956430467e-05,2681
study,2616,56,0.02438274193999385,0.0011090426585336872,2672
open,2543,120,0.023702336679435915,0.002376519982572187,2663
mexican,2659,2,0.024783528600322492,3.960866637620311e-05,2661
golden,2654,3,0.02473692550028428,5.941299956430467e-05,2657
globes,2651,1,0.02470896364026135,1.9804333188101555e-05,2652
without,2505,135,0.023348153119145485,0.0026735849803937103,2640
worker,2615,20,0.024373421319986207,0.00039608666376203115,2635
top,1203,1419,0.01121270586919442,0.02810234879391611,2622
possession,2595,1,0.024187008919833348,1.9804333188101555e-05,2596
party,2277,317,0.021223051757402904,0.006277973620628194,2594
democrats,1302,1245,0.012135447249951067,0.02465639481918644,2547
another,1725,797,0.016078069513184017,0.01578405355091694,2522
hoax,2464,49,0.022966007698832128,0.0009704123262169763,2513
action,2222,242,0.020710417656982543,0.004792648631520576,2464
deported,2396,9,0.02233220553831241,0.000178238998692914,2405
year,2146,254,0.02000205053640168,0.005030300629777796,2400
elected,2370,27,0.022089869418113695,0.000534716996078742,2397
across,2375,14,0.022136472518151908,0.0002772606646334218,2389
man,2198,189,0.020486722776799113,0.0037430189725511944,2387
drug,2323,45,0.021651800277754474,0.00089119499346457,2368
back,1783,580,0.016618665473627305,0.011486513249098903,2363
truly,2338,17,0.02179160957786912,0.00033667366419772645,2355
covington,2352,1,0.02192209825797612,1.9804333188101555e-05,2353
executive,2172,180,0.0202443866566004,0.00356477997385828,2352
complaint,1402,949,0.013067509250715358,0.018794312195508377,2351
catholic,2339,1,0.021800930197876763,1.9804333188101555e-05,2340
harris,2256,83,0.021027318737242402,0.0016437596546124292,2339
target,2325,14,0.021670441517769763,0.0002772606646334218,2339
hes,1747,592,0.01628312315335216,0.011724165247356122,2339
twitter,2135,168,0.019899523716317608,0.0033271279756010613,2303
favor,2187,97,0.02038419595671504,0.001921020319245851,2284
jr,2282,1,0.021269654857441117,1.9804333188101555e-05,2283
election,1612,656,0.015024839452320369,0.01299164257139462,2268
eight,2197,42,0.02047740215679147,0.0008317819939002653,2239
late,2214,20,0.0206358526969214,0.00039608666376203115,2234
wide,2224,6,0.02072905889699783,0.00011882599912860934,2230
cartels,2226,1,0.020747700137013114,1.9804333188101555e-05,2227
overstayers,2222,1,0.020710417656982543,1.9804333188101555e-05,2223
jared,2157,50,0.020104577356485753,0.0009902166594050778,2207
better,2078,126,0.019368248375881962,0.002495345981700796,2204
stays,2124,67,0.019796996896233536,0.0013268903236028043,2191
least,1953,232,0.0182031708749266,0.004594605299639561,2185
foreign,832,1339,0.0077547558463589,0.026518002138867985,2171
shots,2127,36,0.019824958756256467,0.000712955994771656,2163
people,1291,858,0.012032920429866995,0.016992117875391136,2149
search,2145,2,0.019992729916394038,3.960866637620311e-05,2147
westbrook,2142,1,0.01996476805637111,1.9804333188101555e-05,2143
russell,2140,1,0.019946126816355825,1.9804333188101555e-05,2141
practice,2134,3,0.019890203096309966,5.941299956430467e-05,2137
dedicated,2123,11,0.019787676276225893,0.00021784766506911712,2134
enter,863,1270,0.00804369506659583,0.025151503148888976,2133
results,2115,17,0.019713111316164753,0.00033667366419772645,2132
extra,2126,4,0.019815638136248825,7.921733275240622e-05,2130
engine,2128,1,0.01983427937626411,1.9804333188101555e-05,2129
state,664,1456,0.006188891685074891,0.028835109121875868,2120
dealers,2112,2,0.01968514945614182,3.960866637620311e-05,2114
licenses,2110,1,0.019666508216126536,1.9804333188101555e-05,2111
overwhelmingly,2109,2,0.019657187596118893,3.960866637620311e-05,2111
mass,2004,97,0.018678522495316388,0.001921020319245851,2101
bill,1497,567,0.013952968151441434,0.011229056917653583,2064
call,521,1524,0.004856043023981955,0.030181803778666774,2045
know,1146,893,0.010681430528758773,0.01768526953697469,2039
4,1501,525,0.013990250631472006,0.010397274923753317,2026
get,1332,673,0.012415065850180354,0.013328316235592347,2005
dont,1097,890,0.01022472014838427,0.017625856537410386,1987
–,1388,598,0.012937020570608356,0.01184299124648473,1986
kamala,1927,53,0.017960834754727883,0.0010496296589693826,1980
admits,1880,91,0.017522765614368666,0.0018021943201172418,1971
impeachment,1,1961,9.320620007642909e-06,0.038836297381867155,1962
climate,1549,411,0.014437640391838865,0.00813958094030974,1960
duckduckgo,1954,1,0.018212491494934244,1.9804333188101555e-05,1955
report,1735,217,0.016171275713260446,0.0042975403018180374,1952
white,501,1444,0.004669630623829097,0.028597457123618646,1945
general,1271,667,0.011846508029714136,0.013209490236463738,1938
amp,645,1275,0.006011799904929676,0.025250524814829485,1920
im,1662,240,0.015490870452702513,0.004753039965144374,1902
first,670,1219,0.0062448154051207485,0.024141482156295798,1889
accepting,1727,143,0.0160967107531993,0.0028320196458985225,1870
tom,1823,35,0.016991490273933024,0.0006931516615835545,1858
work,1326,530,0.012359142130134497,0.010496296589693825,1856
immigration,1456,389,0.013570822731128074,0.007703885610171506,1845
campaign,73,1757,0.0006804052605579324,0.034796213411494435,1830
serious,1650,178,0.015379023012610798,0.0035251713074820772,1828
freedom,1811,10,0.01687964283384131,0.00019804333188101558,1821
means,1748,62,0.016292443773359803,0.0012278686576622966,1810
breaking,412,1384,0.0038400954431488782,0.027409197132332554,1796
brady,1787,1,0.016655947953657876,1.9804333188101555e-05,1788
say,431,1326,0.0040171872232940935,0.026260545807422663,1757
sure,409,1345,0.0038121335831259495,0.026636828137996595,1754
want,1345,389,0.012536233910279712,0.007703885610171506,1734
trophy,1724,2,0.016068748893176374,3.960866637620311e-05,1726
‘this,1724,1,0.016068748893176374,1.9804333188101555e-05,1725
set,892,830,0.008313993046817474,0.01643759654612429,1722
bidens,1,1720,9.320620007642909e-06,0.03406345308353468,1721
coming,250,1454,0.002330155001910727,0.028795500455499664,1704
biden,285,1416,0.002656376702178229,0.028042935794351805,1701
either,1647,53,0.01535106115258787,0.0010496296589693826,1700
aliens,1676,2,0.015621359132809515,3.960866637620311e-05,1678
city,1642,35,0.015304458052549656,0.0006931516615835545,1677
latest,1418,248,0.013216639170837645,0.004911474630649186,1666
could,1100,562,0.0102526820084072,0.011130035251713076,1662
make,1016,646,0.009469749927765196,0.012793599239513606,1662
fascist,1657,2,0.0154442673526643,3.960866637620311e-05,1659
reporter,1647,10,0.01535106115258787,0.00019804333188101558,1657
behind,1565,88,0.014586770311961152,0.001742781320552937,1653
acosta,1643,3,0.015313778672557298,5.941299956430467e-05,1646
democrat,1467,175,0.013673349551212147,0.003465758307917772,1642
using,1270,365,0.011837187409706493,0.007228581613657068,1635
two,1051,577,0.009795971628032698,0.011427100249534599,1628
end,324,1302,0.0030198808824763025,0.025785241810908226,1626
author,1615,2,0.015052801312343296,3.960866637620311e-05,1617
award,30,1577,0.00027961860022928726,0.031231433437636156,1607
law,328,1279,0.003057163362506874,0.02532974214758189,1607
former,309,1290,0.0028800715823616586,0.025547589812651008,1599
hand,1119,480,0.010429773788552414,0.009506079930288748,1599
world,1342,241,0.012508272050256784,0.004772844298332475,1583
last,1124,443,0.010476376888590629,0.00877331960232899,1567
multiple,4,1563,3.7282480030571634e-05,0.030954172773002733,1567
announces,1482,76,0.013813158851326791,0.0015051293222957183,1558
move,1440,115,0.013421692811005788,0.002277498316631679,1555
died,14,1523,0.00013048868010700072,0.03016199944547867,1537
going,878,650,0.008183504366710474,0.012872816572266011,1528
la,1479,24,0.013785196991303861,0.0004753039965144374,1503
deal,1100,400,0.0102526820084072,0.007921733275240622,1500
americans,1168,329,0.010886484168926918,0.006515625618885412,1497
jessye,1,1495,9.320620007642909e-06,0.029607478116211828,1496
old,1332,164,0.012415065850180354,0.003247910642848655,1496
norman,1,1495,9.320620007642909e-06,0.029607478116211828,1496
dad,1487,8,0.013859761951365004,0.00015843466550481244,1495
bombshell,101,1392,0.0009413826207719338,0.027567631797837368,1493
story,480,1011,0.004473897603668596,0.020022180853170674,1491
since,420,1071,0.003914660403210021,0.021210440844456765,1491
tv,1410,71,0.0131420742107765,0.0014061076563552106,1481
doesnt,1015,464,0.009460429307757551,0.009189210599279123,1479
high,1405,66,0.013095471110738286,0.0013070859904147027,1471
hell,1355,110,0.012629440110356141,0.002178476650691171,1465
phillies,1463,1,0.013636067071181575,1.9804333188101555e-05,1464
winner,13,1450,0.00012116806009935781,0.028716283122747256,1463
74,1,1458,9.320620007642909e-06,0.02887471778825207,1459
voice,7,1452,6.524434005350036e-05,0.02875589178912346,1459
soprano,1,1458,9.320620007642909e-06,0.02887471778825207,1459
regal,1,1456,9.320620007642909e-06,0.028835109121875868,1457
br,1,1453,9.320620007642909e-06,0.02877569612231156,1454
grammy,1,1450,9.320620007642909e-06,0.028716283122747256,1451
shimmering,1,1450,9.320620007642909e-06,0.028716283122747256,1451
think,608,828,0.005666936964646888,0.01639798787974809,1436
senate,18,1415,0.00016777116013757235,0.028023131461163704,1433
‘american,1423,1,0.013263242270875858,1.9804333188101555e-05,1424
bar,1408,14,0.013123432970761215,0.0002772606646334218,1422
attack,892,520,0.008313993046817474,0.01029825325781281,1412
switched,1407,3,0.013114112350753573,5.941299956430467e-05,1410
rerun,1403,1,0.013076829870723,1.9804333188101555e-05,1404
pay,1341,63,0.01249895143024914,0.001247672990850398,1404
police,1333,66,0.012424386470187997,0.0013070859904147027,1399
omar,1276,118,0.01189311112975235,0.0023369113161959836,1394
wing,1349,44,0.012573516390310284,0.0008713906602764685,1393
16,1273,114,0.011865149269729423,0.0022576939834435773,1387
america,902,479,0.008407199246893904,0.009486275597100646,1381
clinton,72,1308,0.0006710846405502894,0.025904067810036836,1380
told,639,731,0.005955876184883819,0.014476967560502239,1370
star,1330,35,0.012396424610165067,0.0006931516615835545,1365
really,1111,248,0.010355208828491272,0.004911474630649186,1359
allowed,31,1323,0.00028893922023693014,0.02620113280785836,1354
asks,1258,79,0.011725339969614779,0.001564542321860023,1337
change,1184,145,0.011035614089049203,0.002871628312274726,1329
likely,39,1287,0.0003635041802980734,0.025488176813086703,1326
million,1163,163,0.010839881068888703,0.003228106309660554,1326
poverty,3,1316,2.7961860022928726e-05,0.02606250247554165,1319
immigrants,732,585,0.0068226938455946086,0.01158553491503941,1317
became,10,1301,9.320620007642909e-05,0.025765437477720126,1311
said,156,1153,0.0014540167211922936,0.022834396165881093,1309
staff,333,976,0.0031037664625450886,0.01932902919158712,1309
denies,1282,24,0.011949034849798208,0.0004753039965144374,1306
oil,1109,191,0.010336567588475985,0.0037826276389273973,1300
grandparents,1,1297,9.320620007642909e-06,0.025686220144967718,1298
harper,1293,1,0.01205156166988228,1.9804333188101555e-05,1294
willing,1257,33,0.011716019349607136,0.0006535429952073513,1290
bryce,1279,1,0.01192107298977528,1.9804333188101555e-05,1280
called,1048,230,0.009768009768009768,0.004554996633263358,1278
measure,4,1268,3.7282480030571634e-05,0.025111894482512775,1272
official,157,1114,0.0014633373411999367,0.022062027171545134,1271
wouldve,5,1264,4.660310003821454e-05,0.025032677149760367,1269
good,774,494,0.007214159885915611,0.009783340594922169,1268
kushners,1265,1,0.011790584309668279,1.9804333188101555e-05,1266
promotion,1265,1,0.011790584309668279,1.9804333188101555e-05,1266
fled,2,1264,1.8641240015285817e-05,0.025032677149760367,1266
bricklayers,1,1264,9.320620007642909e-06,0.025032677149760367,1265
act,833,429,0.007764076466366543,0.008496058937695568,1262
looks,895,363,0.008341954906840403,0.007188972947280865,1258
second,63,1182,0.0005871990604815032,0.02340872182833604,1245
see,973,269,0.00906896326743655,0.005327365627599319,1242
piece,1106,135,0.010308605728453057,0.0026735849803937103,1241
pompeo,15,1225,0.00013980930011464363,0.024260308155424407,1240
green,1116,122,0.010401811928529486,0.00241612864894839,1238
china,703,535,0.006552395865372964,0.010595318255634333,1238
accused,1152,85,0.01073735424880463,0.0016833683209886323,1237
half,1199,26,0.011175423389163847,0.0005149126628906405,1225
obama,773,448,0.007204839265907969,0.008872341268269497,1221
defends,1137,82,0.010597544948689986,0.0016239553214243275,1219
3,939,280,0.00875206218717669,0.005545213292668436,1219
ban,1048,167,0.009768009768009768,0.00330732364241296,1215
national,451,762,0.004203599623446952,0.015090901889333387,1213
federal,254,957,0.002367437481941299,0.01895274686101319,1211
current,1069,139,0.00996374278817027,0.002752802313146116,1208
freedoms,1204,3,0.011222026489202062,5.941299956430467e-05,1207
gop,332,870,0.0030944458425374455,0.017229769873648354,1202
nyt,31,1167,0.00028893922023693014,0.023111656830514516,1198
much,330,861,0.00307580460252216,0.01705153087495544,1191
wielding,1188,1,0.011072896569079775,1.9804333188101555e-05,1189
schooler,1188,1,0.011072896569079775,1.9804333188101555e-05,1189
freedoming,1188,1,0.011072896569079775,1.9804333188101555e-05,1189
classmates,1188,1,0.011072896569079775,1.9804333188101555e-05,1189
thanks,97,1086,0.0009041001407413622,0.021507505842278292,1183
legal,852,331,0.007941168246511757,0.006555234285261616,1183
left,952,229,0.00887323024727605,0.004535192300075257,1181
linked,9,1172,8.388558006878618e-05,0.023210678496455025,1181
cent,1172,1,0.010923766648957488,1.9804333188101555e-05,1173
dems,488,682,0.00454846256372974,0.013506555234285261,1170
political,171,989,0.0015938260213069373,0.01958648552303244,1160
ditch,1066,90,0.00993578092814734,0.00178238998692914,1156
calls,462,694,0.004306126443531024,0.01374420723254248,1156
bigot,1124,29,0.010476376888590629,0.0005743256624549452,1153
sick,1003,147,0.009348581867665837,0.0029112369786509287,1150
hamas,1149,1,0.010709392388781701,1.9804333188101555e-05,1150
arrested,846,300,0.0078852445264659,0.005941299956430467,1146
projected,1145,1,0.01067210990875113,1.9804333188101555e-05,1146
woman,1094,46,0.010196758288361342,0.0009109993266526716,1140
life,759,381,0.007074350585800968,0.007545450944666693,1140
excuse,747,390,0.006962503145709253,0.007723689943359607,1137
rabid,1123,2,0.010467056268582986,3.960866637620311e-05,1125
weapons,1115,5,0.010392491308521844,9.902166594050779e-05,1120
tell,976,139,0.00909692512745948,0.002752802313146116,1115
mr,50,1062,0.00046603100038214543,0.02103220184576385,1112
cant,685,426,0.006384624705235392,0.008436645938131263,1111
tax,563,536,0.005247509064302957,0.010615122588822435,1099
needs,181,910,0.0016870322213833665,0.018021943201172418,1091
literally,954,136,0.008891871487291335,0.0026933893135818116,1090
2016,23,1062,0.0002143742601757869,0.02103220184576385,1085
officials,61,1015,0.0005685578204662175,0.02010139818592308,1076
executives,1064,3,0.009917139688132055,5.941299956430467e-05,1067
provides,1063,2,0.009907819068124412,3.960866637620311e-05,1065
whereabouts,1063,1,0.009907819068124412,1.9804333188101555e-05,1064
locations,1063,1,0.009907819068124412,1.9804333188101555e-05,1064
oscars,1057,1,0.009851895348078555,1.9804333188101555e-05,1058
israel,1054,3,0.009823933488055625,5.941299956430467e-05,1057
crime,983,73,0.00916216946751298,0.0014457163227314135,1056
elizabeth,613,436,0.005713540064685103,0.008634689270012279,1049
never,455,591,0.004240882103477523,0.01170436091416802,1046
wall,648,396,0.006039761764952605,0.007842515942488217,1044
10,550,490,0.0051263410042036,0.009704123262169764,1040
happening,1021,18,0.009516353027803409,0.000356477997385828,1039
way,439,595,0.004091752183355237,0.011783578246920426,1034
mcconnell,2,1031,1.8641240015285817e-05,0.020418267516932705,1033
put,657,375,0.006123647345021391,0.007426624945538083,1032
alleged,890,142,0.008295351806802189,0.002812215312710421,1032
judge,274,753,0.002553849882094157,0.014912662890640473,1027
public,213,814,0.0019852920616279393,0.016120727215114667,1027
2020,662,359,0.006170250445059605,0.007109755614528459,1021
getting,219,796,0.0020412157816737967,0.01576424921772884,1015
krassensteins,1011,1,0.009423146827726981,1.9804333188101555e-05,1012
isnt,330,677,0.00307580460252216,0.013407533568344754,1007
isis,896,100,0.008351275526848046,0.0019804333188101556,996
go,763,232,0.007111633065831539,0.004594605299639561,995
day,308,678,0.002870750962354016,0.013427337901532855,986
country,433,550,0.0040358284633093796,0.010892383253455856,983
votes,946,34,0.00881730652723019,0.0006733473283954529,980
right,512,467,0.004772157443913169,0.009248623598843427,979
plan,676,301,0.006300739125166606,0.005961104289618569,977
justice,503,459,0.004688271863844383,0.009090188933338614,962
poll,39,922,0.0003635041802980734,0.018259595199429636,961
syria,367,590,0.0034206675428049473,0.01168455658097992,957
admin,155,802,0.0014446961011846508,0.01588307521685745,957
htt,709,247,0.0066083195854188224,0.004891670297461084,956
turn,807,147,0.007521740346167827,0.0029112369786509287,954
buying,923,25,0.008602932267054405,0.0004951083297025389,948
support,189,759,0.0017615971814445098,0.015031488889769082,948
veritas,944,1,0.008798665287214905,1.9804333188101555e-05,945
ground,905,38,0.008435161106916831,0.0007525646611478592,943
project,936,7,0.008724100327153763,0.0001386303323167109,943
money,503,436,0.004688271863844383,0.008634689270012279,939
found,287,649,0.0026750179421935146,0.01285301223907791,936
must,473,463,0.004408653263615095,0.00916940626609102,936
jussie,932,1,0.00868681784712319,1.9804333188101555e-05,933
trying,732,200,0.0068226938455946086,0.003960866637620311,932
crimes,518,414,0.004828081163959027,0.008198993939874045,932
war,747,182,0.006962503145709253,0.0036043886402344835,929
years,500,426,0.004660310003821454,0.008436645938131263,926
living,904,20,0.008425840486909189,0.00039608666376203115,924
potentially,856,67,0.00797845072654233,0.0013268903236028043,923
rights,875,47,0.008155542506687544,0.0009308036598407732,922
friends,914,6,0.008519046686985618,0.00011882599912860934,920
forward,427,492,0.003979904743263522,0.009743731928545966,919
democratvoterfraud,911,1,0.008491084826962689,1.9804333188101555e-05,912
chicago,909,2,0.008472443586947404,3.960866637620311e-05,911
nunes,7,903,6.524434005350036e-05,0.017883312868855705,910
giant,904,6,0.008425840486909189,0.00011882599912860934,910
demonic,906,2,0.008444481726924476,3.960866637620311e-05,908
belichick,902,1,0.008407199246893904,1.9804333188101555e-05,903
bursts,900,2,0.008388558006878618,3.960866637620311e-05,902
drags,900,1,0.008388558006878618,1.9804333188101555e-05,901
department,4,896,3.7282480030571634e-05,0.017744682536538995,900
prevent,855,44,0.007969130106534687,0.0008713906602764685,899
human,823,75,0.007670870266290114,0.0014853249891076167,898
congress,34,861,0.0003169010802598589,0.01705153087495544,895
smollett,892,1,0.008313993046817474,1.9804333188101555e-05,893
baby,804,87,0.007493778486144898,0.0017229769873648355,891
5,648,243,0.006039761764952605,0.0048124529647086784,891
pissed,879,5,0.008192824986718117,9.902166594050779e-05,884
goff,876,1,0.008164863126695187,1.9804333188101555e-05,877
stop,317,560,0.002954636542422802,0.011090426585336871,877
disappeared,869,1,0.008099618786641687,1.9804333188101555e-05,870
texas,758,103,0.007065029965793324,0.00203984631837446,861
democratic,150,710,0.0013980930011464362,0.014061076563552105,860
vote,654,204,0.006095685484998462,0.004040083970372718,858
even,277,579,0.0025818117421170855,0.011466708915910801,856
deactivation,851,1,0.007931847626504115,1.9804333188101555e-05,852
schiff,2,850,1.8641240015285817e-05,0.016833683209886322,852
exec,812,36,0.007568343446206042,0.000712955994771656,848
republican,42,803,0.00039146604032100216,0.01590287955004555,845
aoc,457,387,0.004259523343492809,0.007664276943795303,844
hands,826,16,0.0076988321263130426,0.0003168693310096249,842
joe,336,505,0.0031317283225680173,0.010001188259991287,841
able,819,21,0.007633587786259542,0.00041589099695013267,840
fox,131,708,0.001221001221001221,0.014021467897175902,839
suing,777,60,0.00724212174593854,0.0011882599912860935,837
letter,276,561,0.002572491122109443,0.011110230918524974,837
come,671,155,0.006254136025128392,0.0030696716441557413,826
aag,805,19,0.007503099106152542,0.0003762823305739296,824
lottery,820,1,0.007642908406267185,1.9804333188101555e-05,821
1,544,274,0.005070417284157742,0.0054263872935398265,818
game,745,73,0.006943861905693967,0.0014457163227314135,818
men,734,83,0.006841335085609895,0.0016437596546124292,817
still,641,169,0.005974517424899104,0.003346932308789163,810
blame,748,58,0.0069718237657168955,0.0011486513249098903,806
rape,804,1,0.007493778486144898,1.9804333188101555e-05,805
book,718,87,0.0066922051654876085,0.0017229769873648355,805
hate,624,178,0.0058160668847691745,0.0035251713074820772,802
son,53,749,0.0004939928604050742,0.014833445557888066,802
mark,515,284,0.004800119303936098,0.005624430625420842,799
w,348,448,0.003243575762659732,0.008872341268269497,796
enough,584,210,0.005443242084463459,0.004158909969501327,794
help,217,577,0.002022574541658511,0.011427100249534599,794
believe,485,307,0.004520500703706811,0.006079930288747178,792
investigation,465,326,0.004334088303553953,0.006456212619321108,791
intel,51,738,0.0004753516203897883,0.014615597892818948,789
thats,468,319,0.004362050163576881,0.006317582287004396,787
long,503,279,0.004688271863844383,0.0055254089594803345,782
patriots,763,16,0.007111633065831539,0.0003168693310096249,779
barr,3,775,2.7961860022928726e-05,0.015348358220778706,778
marxism,776,1,0.007232801125930897,1.9804333188101555e-05,777
adviser,136,640,0.0012676043210394356,0.012674773240384997,776
impeach,4,772,3.7282480030571634e-05,0.015288945221214401,776
got,252,519,0.002348796241926013,0.010278448924624707,771
migrants,502,265,0.00467895124383674,0.005248148294846913,767
californias,39,726,0.0003635041802980734,0.01437794589456173,765
far,658,106,0.006132967965029034,0.002099259317938765,764
three,396,367,0.0036909655230265917,0.007268190280033272,763
facebook,724,39,0.006748128885533466,0.0007723689943359607,763
billion,485,274,0.004520500703706811,0.0054263872935398265,759
draft,718,38,0.0066922051654876085,0.0007525646611478592,756
nearly,594,155,0.0055364482845398875,0.0030696716441557413,749
diplomat,1,746,9.320620007642909e-06,0.014774032558323762,747
list,574,172,0.005350035884387029,0.0034063453083534676,746
family,590,154,0.005499165804509316,0.0030498673109676396,744
hungry,729,15,0.00679473198557168,0.00029706499782152337,744
eric,738,3,0.006878617565640467,5.941299956430467e-05,741
bernie,573,166,0.005340715264379387,0.0032875193092248584,739
el,472,261,0.004399332643607453,0.005168930962094506,733
didnt,307,425,0.002861430342346373,0.008416841604943161,732
many,500,227,0.004660310003821454,0.004495583633699053,727
partnership,725,2,0.0067574495055411085,3.960866637620311e-05,727
fromsoftware,725,1,0.0067574495055411085,1.9804333188101555e-05,726
carle,725,1,0.0067574495055411085,1.9804333188101555e-05,726
caterpillars,725,1,0.0067574495055411085,1.9804333188101555e-05,726
may,93,630,0.0008668176607107905,0.012476729908503981,723
attorney,19,702,0.00017709178014521526,0.013902641898047293,721
dangerous,151,566,0.001407413621154079,0.01120925258446548,717
auto,2,714,1.8641240015285817e-05,0.014140293896304511,716
maga,690,24,0.006431227805273607,0.0004753039965144374,714
cnnpolitics,1,712,9.320620007642909e-06,0.014100685229928309,713
sanders,507,204,0.004725554343874954,0.004040083970372718,711
meet,13,697,0.00012116806009935781,0.013803620232106784,710
evidence,161,545,0.0015006198212305082,0.010793361587515348,706
iran,282,420,0.0026284148421553003,0.008317819939002654,702
king,677,24,0.006310059745174249,0.0004753039965144374,701
facts,260,440,0.0024233612019871563,0.008713906602764684,700
nothing,283,412,0.002637735462162943,0.00815938527349784,695
every,361,333,0.00336474382275909,0.006594842951637818,694
born,579,114,0.005396638984425244,0.0022576939834435773,693
steele,677,14,0.006310059745174249,0.0002772606646334218,691
women,498,193,0.004641668763806168,0.0038222363053036002,691
investigate,73,617,0.0006804052605579324,0.01221927357705866,690
abc,174,514,0.001621787881329866,0.0101794272586842,688
excellent,678,9,0.006319380365181892,0.000178238998692914,687
days,461,226,0.0042968058235233805,0.004475779300510952,687
decades,597,88,0.005564410144562816,0.001742781320552937,685
often,26,659,0.00024233612019871562,0.013051055570958927,685
big,515,169,0.004800119303936098,0.003346932308789163,684
ever,401,282,0.0037375686230648065,0.005584821959044639,683
play,621,61,0.005788105024746246,0.001208064324474195,682
kill,647,35,0.0060304411449449615,0.0006931516615835545,682
whether,54,627,0.000503313480412717,0.012417316908939676,681
government,233,447,0.0021717044617807976,0.008852536935081395,680
check,448,232,0.004175637763424023,0.004594605299639561,680
screwing,678,1,0.006319380365181892,1.9804333188101555e-05,679
consultant,677,1,0.006310059745174249,1.9804333188101555e-05,678
pooch,677,1,0.006310059745174249,1.9804333188101555e-05,678
prepares,677,1,0.006310059745174249,1.9804333188101555e-05,678
authority,3,675,2.7961860022928726e-05,0.01336792490196855,678
cooper,670,8,0.0062448154051207485,0.00015843466550481244,678
decries,676,1,0.006300739125166606,1.9804333188101555e-05,677
intelligence,41,635,0.0003821454203133592,0.012575751574444488,676
requests,602,74,0.005611013244601031,0.0014655206559195152,676
love,424,250,0.0039519428832405935,0.004951083297025389,674
service,57,615,0.0005312753404356458,0.012179664910682458,672
revokes,1,669,9.320620007642909e-06,0.01324909890283994,670
👇🏻cia,666,1,0.006207532925090177,1.9804333188101555e-05,667
dossier”,666,1,0.006207532925090177,1.9804333188101555e-05,667
bradley,664,1,0.006188891685074891,1.9804333188101555e-05,665
records,584,74,0.005443242084463459,0.0014655206559195152,658
mitch,1,655,9.320620007642909e-06,0.01297183823820652,656
queen,652,3,0.006077044244983176,5.941299956430467e-05,655
epstein,576,78,0.005368677124402315,0.0015447379886719215,654
ole,3,651,2.7961860022928726e-05,0.012892620905454113,654
bars,647,7,0.0060304411449449615,0.0001386303323167109,654
give,520,133,0.004846722403974313,0.002633976314017507,653
—,401,246,0.0037375686230648065,0.004871865964272983,647
mileage,1,646,9.320620007642909e-06,0.012793599239513606,647
show,322,322,0.0030012396424610164,0.006376995286568701,644
made,272,365,0.002535208642078871,0.007228581613657068,637
gets,551,85,0.005135661624211242,0.0016833683209886323,636
wants,409,224,0.0038121335831259495,0.004436170634134749,633
rep,229,404,0.002134421981750226,0.008000950607993029,633
health,305,324,0.0028427891023310873,0.006416603952944904,629
prosecutor,3,626,2.7961860022928726e-05,0.012397512575751574,629
find,35,594,0.0003262217002675018,0.011763773913732324,629
allow,442,185,0.004119714043378166,0.003663801639798788,627
censorship,623,3,0.005806746264761532,5.941299956430467e-05,626
russia,220,403,0.00205053640168144,0.007981146274804927,623
stephen,561,58,0.005228867824287672,0.0011486513249098903,619
testify,1,617,9.320620007642909e-06,0.01221927357705866,618
today,22,594,0.000205053640168144,0.011763773913732324,616
mike,230,386,0.002143742601757869,0.0076444726106072005,616
conspiracy,59,556,0.0005499165804509316,0.011011209252584465,615
job,499,116,0.004650989383813811,0.0022973026498197806,615
habit,357,258,0.003327461342728518,0.005109517962530201,615
senators,42,572,0.00039146604032100216,0.01132807858359409,614
activists,522,91,0.004865363643989598,0.0018021943201172418,613
officers,76,536,0.000708367120580861,0.010615122588822435,612
ukrainian,1,610,9.320620007642909e-06,0.01208064324474195,611
pretending,599,10,0.005583051384578102,0.00019804333188101558,609
court,82,525,0.0007642908406267185,0.010397274923753317,607
information,117,489,0.0010905125408942203,0.009684318928981661,606
meddling,600,6,0.005592372004585745,0.00011882599912860934,606
exist,601,3,0.0056016926245933876,5.941299956430467e-05,604
red,557,46,0.0051915853442571,0.0009109993266526716,603
young,572,30,0.005331394644371743,0.0005941299956430467,602
dealings,1,598,9.320620007642909e-06,0.01184299124648473,599
algorythmic,597,1,0.005564410144562816,1.9804333188101555e-05,598
great,284,312,0.002647056082170586,0.006178951954687686,596
warren,56,537,0.0005219547204280029,0.010634926922010537,593
trial,6,587,5.592372004585745e-05,0.011625143581415615,593
id,40,552,0.00037282480030571634,0.01093199191983206,592
presidential,7,585,6.524434005350036e-05,0.01158553491503941,592
york,148,444,0.0013794517611311504,0.00879312393551709,592
pushed,26,563,0.00024233612019871562,0.011149839584901176,589
wont,468,121,0.004362050163576881,0.002396324315760288,589
united,410,179,0.0038214542031335926,0.0035449756406701785,589
45,262,326,0.002442002442002442,0.006456212619321108,588
nation,358,229,0.0033367819627361612,0.004535192300075257,587
unnerved,559,28,0.005210226584272386,0.0005545213292668436,587
wouldnt,522,65,0.004865363643989598,0.0012872816572266012,587
states,323,264,0.0030105602624686595,0.005228343961658811,587
insane,521,66,0.004856043023981955,0.0013070859904147027,587
fired,482,104,0.004492538843683882,0.002059650651562562,586
sex,556,30,0.005182264724249457,0.0005941299956430467,586
theyre,432,152,0.004026507843301736,0.0030102586445914367,584
rest,544,40,0.005070417284157742,0.0007921733275240623,584
agree,52,530,0.00048467224039743125,0.010496296589693825,582
something,445,134,0.004147675903401094,0.0026537806472056087,579
ending,214,365,0.0019946126816355824,0.007228581613657068,579
youre,374,205,0.0034859118828584478,0.004059888303560819,579
well,239,332,0.002227628181826655,0.006575038618449717,571
throw,558,13,0.005200905964264743,0.00025745633144532023,571
served,17,551,0.00015845054012992945,0.010912187586643958,568
newly,1,566,9.320620007642909e-06,0.01120925258446548,567
loud,452,114,0.004212920243454594,0.0022576939834435773,566
royal,559,6,0.005210226584272386,0.00011882599912860934,565
feds,538,26,0.005014493564111885,0.0005149126628906405,564
keep,252,312,0.002348796241926013,0.006178951954687686,564
‘how,563,1,0.005247509064302957,1.9804333188101555e-05,564
millers,561,2,0.005228867824287672,3.960866637620311e-05,563
role,485,77,0.004520500703706811,0.0015249336554838198,562
asked,149,413,0.0013887723811387934,0.008179189606685943,562
sample,560,2,0.005219547204280028,3.960866637620311e-05,562
officer,493,68,0.0045950656637679535,0.0013466946567909058,561
asking,402,159,0.003746889243072449,0.0031488889769081476,561
hope,403,157,0.003756209863080092,0.003109280310531944,560
probe,53,507,0.0004939928604050742,0.010040796926367489,560
expected,344,215,0.0032062932826291603,0.004257931635441835,559
muslim,526,32,0.00490264612402017,0.0006337386620192498,558
games,527,31,0.004911966744027813,0.0006139343288311483,558
private,318,239,0.0029639571624304447,0.004733235631956272,557
goin,552,3,0.005144982244218886,5.941299956430467e-05,555
pass,542,11,0.005051776044142456,0.00021784766506911712,553
perpetrated,548,2,0.005107699764188314,3.960866637620311e-05,550
tragedy,548,1,0.005107699764188314,1.9804333188101555e-05,549
senseless,548,1,0.005107699764188314,1.9804333188101555e-05,549
outcome,538,10,0.005014493564111885,0.00019804333188101558,548
decided,2,546,1.8641240015285817e-05,0.01081316592070345,548
accurately,524,22,0.004884004884004884,0.00043569533013823424,546
julian,538,8,0.005014493564111885,0.00015843466550481244,546
abrams,424,122,0.0039519428832405935,0.00241612864894839,546
face,391,155,0.0036443624229883773,0.0030696716441557413,546
failing,4,541,3.7282480030571634e-05,0.010714144254762942,545
gone,406,138,0.003784171723103021,0.002732997979958015,544
formal,427,117,0.003979904743263522,0.0023171069830078823,544
leader,263,279,0.002451323062010085,0.0055254089594803345,542
convicted,397,144,0.0037002861430342347,0.002851823979086624,541
run,317,224,0.002954636542422802,0.004436170634134749,541
socialism,496,45,0.004623027523790882,0.00089119499346457,541
2018,515,25,0.004800119303936098,0.0004951083297025389,540
use,398,140,0.0037096067630418774,0.002772606646334218,538
posts,22,515,0.000205053640168144,0.010199231591872302,537
need,284,253,0.002647056082170586,0.0050104962965896935,537
republicans,22,513,0.000205053640168144,0.010159622925496098,535
damn,511,24,0.004762836823905527,0.0004753039965144374,535
violated,1,533,9.320620007642909e-06,0.01055570958925813,534
abortion,412,119,0.0038400954431488782,0.0023567156493840852,531
applications,1,530,9.320620007642909e-06,0.010496296589693825,531
standards,17,513,0.00015845054012992945,0.010159622925496098,530
claims,78,452,0.0007270083605961468,0.008951558601021904,530
th,30,500,0.00027961860022928726,0.009902166594050778,530
sounds,38,492,0.0003541835602904305,0.009743731928545966,530
lewandowski,1,528,9.320620007642909e-06,0.010456687923317621,529
killer,408,120,0.0038028129631183065,0.002376519982572187,528
straight,475,52,0.004427294503630381,0.001029825325781281,527
afghans,1,526,9.320620007642909e-06,0.010417079256941419,527
20,478,49,0.00445525636365331,0.0009704123262169763,527
tony,523,1,0.004874684263997241,1.9804333188101555e-05,524
predicts,522,2,0.004865363643989598,3.960866637620311e-05,524
edelmans,522,1,0.004865363643989598,1.9804333188101555e-05,523
romo,522,1,0.004865363643989598,1.9804333188101555e-05,523
disgusting,403,120,0.003756209863080092,0.002376519982572187,523
office,223,300,0.0020784982617043685,0.005941299956430467,523
killing,511,11,0.004762836823905527,0.00021784766506911712,522
sweden,521,1,0.004856043023981955,1.9804333188101555e-05,522
resolve,3,519,2.7961860022928726e-05,0.010278448924624707,522
volker,1,520,9.320620007642909e-06,0.01029825325781281,521
john,78,443,0.0007270083605961468,0.00877331960232899,521
ruled,1,519,9.320620007642909e-06,0.010278448924624707,520
mice,517,1,0.004818760543951384,1.9804333188101555e-05,518
calling,373,144,0.0034765912628508047,0.002851823979086624,517
grandson,2,515,1.8641240015285817e-05,0.010199231591872302,517
cousin,1,515,9.320620007642909e-06,0.010199231591872302,516
nephew,1,515,9.320620007642909e-06,0.010199231591872302,516
nbcwsj,1,513,9.320620007642909e-06,0.010159622925496098,514
splanin,1,512,9.320620007642909e-06,0.010139818592307996,513
bejing,1,512,9.320620007642909e-06,0.010139818592307996,513
shot,471,42,0.00439001202359981,0.0008317819939002653,513
nadler,1,508,9.320620007642909e-06,0.010060601259555591,509
lost,440,68,0.00410107280336288,0.0013466946567909058,508
write,11,496,0.000102526820084072,0.009822949261298373,507
impeached,2,504,1.8641240015285817e-05,0.009981383926803184,506
moving,419,87,0.0039053397832023787,0.0017229769873648355,506
90,413,91,0.0038494160631565213,0.0018021943201172418,504
policy,279,224,0.0026004529821323716,0.004436170634134749,503
recuse,1,501,9.320620007642909e-06,0.00992197092723888,502
remove,456,46,0.0042502027234851665,0.0009109993266526716,502
voters,389,112,0.0036257211829730913,0.0022180853170673744,501
ny,227,273,0.0021157807417349402,0.005406582960351725,500
innoc,1,498,9.320620007642909e-06,0.009862557927674575,499
best,432,67,0.004026507843301736,0.0013268903236028043,499
15,318,180,0.0029639571624304447,0.00356477997385828,498
force,300,197,0.0027961860022928725,0.0039014536380560065,497
verify,465,31,0.004334088303553953,0.0006139343288311483,496
condoms,494,1,0.004604386283775597,1.9804333188101555e-05,495
juice,491,3,0.004576424423752668,5.941299956430467e-05,494
knowledge,4,489,3.7282480030571634e-05,0.009684318928981661,493
less,334,159,0.003113087082552731,0.0031488889769081476,493
committed,304,189,0.002833468482323444,0.0037430189725511944,493
meat,481,12,0.004483218223676239,0.0002376519982572187,493
fails,204,288,0.0019014064815591532,0.005703647958173248,492
military,114,378,0.0010625506808712916,0.007486037945102389,492
beet,490,1,0.004567103803745025,1.9804333188101555e-05,491
eating,484,6,0.0045111800836991674,0.00011882599912860934,490
case,97,392,0.0009041001407413622,0.0077632986097358105,489
http,391,98,0.0036443624229883773,0.0019408246524339526,489
team,284,204,0.002647056082170586,0.004040083970372718,488
sniper,486,1,0.0045298213237144535,1.9804333188101555e-05,487
subpoena,1,486,9.320620007642909e-06,0.009624905929417357,487
taxes,471,15,0.00439001202359981,0.00029706499782152337,486
else,457,29,0.004259523343492809,0.0005743256624549452,486
impossible,477,8,0.004445935743645667,0.00015843466550481244,485
burgers,475,8,0.004427294503630381,0.00015843466550481244,483
chapter,349,133,0.003252896382667375,0.002633976314017507,482
interesting,15,467,0.00013980930011464363,0.009248623598843427,482
signed,32,450,0.0002982598402445731,0.0089119499346457,482
wanted,24,458,0.0002236948801834298,0.009070384600150513,482
confirms,86,395,0.0008015733206572901,0.007822711609300115,481
introduces,427,54,0.003979904743263522,0.001069433992157484,481
level,449,30,0.004184958383431666,0.0005941299956430467,479
protesting,477,1,0.004445935743645667,1.9804333188101555e-05,478
directed,451,27,0.004203599623446952,0.000534716996078742,478
doused,474,2,0.004417973883622739,3.960866637620311e-05,476
goes,210,266,0.0019573302016050106,0.005267952628035014,476
company,403,72,0.003756209863080092,0.001425911989543312,475
fully,458,17,0.004268843963500452,0.00033667366419772645,475
allegation,466,9,0.004343408923561595,0.000178238998692914,475
sen,106,367,0.0009879857208101484,0.007268190280033272,473
violence,137,336,0.0012769249410470784,0.006654255951202123,473
none,8,464,7.456496006114327e-05,0.009189210599279123,472
diners,471,1,0.00439001202359981,1.9804333188101555e-05,472
death,323,148,0.0030105602624686595,0.0029310413118390304,471
thought,316,155,0.002945315922415159,0.0030696716441557413,471
sdny,467,3,0.004352729543569238,5.941299956430467e-05,470
leaders,91,375,0.0008481764206955047,0.007426624945538083,466
someone,310,155,0.0028893922023693016,0.0030696716441557413,465
tells,75,390,0.0006990465005732181,0.007723689943359607,465
paid,448,16,0.004175637763424023,0.0003168693310096249,464
charges,212,251,0.0019759714416202967,0.004970887630213491,463
weighing,1,462,9.320620007642909e-06,0.009149601932902918,463
next,190,271,0.0017709178014521526,0.005366974293975522,461
giuliani,42,419,0.00039146604032100216,0.008298015605814552,461
savage,458,1,0.004268843963500452,1.9804333188101555e-05,459
bush,279,180,0.0026004529821323716,0.00356477997385828,459
ilhan,397,62,0.0037002861430342347,0.0012278686576622966,459
later,4,454,3.7282480030571634e-05,0.008991167267398107,458
course,367,91,0.0034206675428049473,0.0018021943201172418,458
ukraines,1,457,9.320620007642909e-06,0.009050580266962411,458
comes,58,399,0.0005405959604432886,0.007901928942052522,457
documents,76,379,0.000708367120580861,0.00750584227829049,455
energy,300,155,0.0027961860022928725,0.0030696716441557413,455
chiefs,2,453,1.8641240015285817e-05,0.008971362934210005,455
fbi,355,100,0.0033088201027132325,0.0019804333188101556,455
absolutely,98,356,0.000913420760749005,0.0070503426149641545,454
citizens,350,104,0.0032622170026750177,0.002059650651562562,454
london,451,2,0.004203599623446952,3.960866637620311e-05,453
particular,452,1,0.004212920243454594,1.9804333188101555e-05,453
‘you,452,1,0.004212920243454594,1.9804333188101555e-05,453
statement,60,392,0.0005592372004585745,0.0077632986097358105,452
h,178,274,0.0016590703613604378,0.0054263872935398265,452
releases,399,51,0.0037189273830495204,0.0010100209925931795,450
group,289,161,0.0026936591822088007,0.0031884976432843505,450
came,291,159,0.0027123004222240864,0.0031488889769081476,450
yet,219,231,0.0020412157816737967,0.004574800966451459,450
unveils,426,24,0.003970584123255879,0.0004753039965144374,450
winning,426,23,0.003970584123255879,0.0004554996633263358,449
trade,182,266,0.0016963528413910093,0.005267952628035014,448
hold,136,312,0.0012676043210394356,0.006178951954687686,448
girls,446,1,0.004156996523408737,1.9804333188101555e-05,447
chapo,446,1,0.004156996523408737,1.9804333188101555e-05,447
highest,441,5,0.004110393423370522,9.902166594050779e-05,446
entered,445,1,0.004147675903401094,1.9804333188101555e-05,446
testing,395,50,0.0036816449030189487,0.0009902166594050778,445
refuse,435,10,0.004054469703324665,0.00019804333188101558,445
kazakhstan,442,1,0.004119714043378166,1.9804333188101555e-05,443
maybe,84,359,0.0007829320806420043,0.007109755614528459,443
👍🇺🇸,1,441,9.320620007642909e-06,0.008733710935952786,442
hearing,39,402,0.0003635041802980734,0.007961341941616826,441
population,438,3,0.0040824315633475935,5.941299956430467e-05,441
care,196,245,0.00182684152149801,0.004852061631084882,441
clause,406,35,0.003784171723103021,0.0006931516615835545,441
veterans,389,51,0.0036257211829730913,0.0010100209925931795,440
camera,438,2,0.0040824315633475935,3.960866637620311e-05,440
field,311,129,0.0028987128223769447,0.0025547589812651007,440
trafficking,417,22,0.0038866985431870926,0.00043569533013823424,439
nationwide,3,435,2.7961860022928726e-05,0.008614884936824177,438
secretary,11,426,0.000102526820084072,0.008436645938131263,437
usa,43,394,0.00040078666032864504,0.007802907276112013,437
urge,406,31,0.003784171723103021,0.0006139343288311483,437
thing,298,139,0.002777544762277587,0.002752802313146116,437
corrupt,233,203,0.0021717044617807976,0.004020279637184616,436
black,301,135,0.0028055066223005155,0.0026735849803937103,436
delingpole,434,1,0.004045149083317022,1.9804333188101555e-05,435
pro,256,178,0.0023860787219565846,0.0035251713074820772,434
zelensky,1,433,9.320620007642909e-06,0.008575276270447975,434
watch,394,37,0.003672324283011306,0.0007327603279597576,431
allies,1,429,9.320620007642909e-06,0.008496058937695568,430
wit,2,427,1.8641240015285817e-05,0.008456450271319365,429
meryl,428,1,0.003989225363271165,1.9804333188101555e-05,429
history,208,221,0.001938688961589725,0.004376757634570444,429
trojan,426,1,0.003970584123255879,1.9804333188101555e-05,427
streep,426,1,0.003970584123255879,1.9804333188101555e-05,427
criminal,171,255,0.0015938260213069373,0.005050104962965897,426
chewbacca,425,1,0.003961263503248236,1.9804333188101555e-05,426
reparations,424,1,0.0039519428832405935,1.9804333188101555e-05,425
—gt,407,18,0.003793492343110664,0.000356477997385828,425
hey,346,79,0.0032249345226444464,0.001564542321860023,425
jj,424,1,0.0039519428832405935,1.9804333188101555e-05,425
jerry,2,422,1.8641240015285817e-05,0.008357428605378856,424
also,107,317,0.0009973063408177912,0.006277973620628194,424
race,49,375,0.0004567103803745025,0.007426624945538083,424
anywhere,421,2,0.003923981023217665,3.960866637620311e-05,423
clear,30,393,0.00027961860022928726,0.007783102942923912,423
committee,70,353,0.0006524434005350035,0.00699092961539985,423
ig,1,421,9.320620007642909e-06,0.008337624272190756,422
vice,214,206,0.0019946126816355824,0.00407969263674892,420
booker,382,38,0.003560476842919591,0.0007525646611478592,420
7,354,66,0.0032994994827055895,0.0013070859904147027,420
actual,377,43,0.0035138737428813765,0.0008515863270883669,420
file,10,409,9.320620007642909e-05,0.008099972273933536,419
checks,370,48,0.003448629402827876,0.0009506079930288747,418
un,117,301,0.0010905125408942203,0.005961104289618569,418
arrest,298,120,0.002777544762277587,0.002376519982572187,418
wins,401,17,0.0037375686230648065,0.00033667366419772645,418
pelosi,64,353,0.0005965196804891462,0.00699092961539985,417
filed,1,415,9.320620007642909e-06,0.008218798273062145,416
victory,403,12,0.003756209863080092,0.0002376519982572187,415
notice,7,408,6.524434005350036e-05,0.008080167940745436,415
immediately,223,192,0.0020784982617043685,0.003802431972115499,415
backs,401,14,0.0037375686230648065,0.0002772606646334218,415
boston,412,2,0.0038400954431488782,3.960866637620311e-05,414
looking,162,252,0.0015099404412381512,0.004990691963401592,414
2,197,216,0.001836162141505653,0.004277735968629936,413
whistleblowers,1,412,9.320620007642909e-06,0.00815938527349784,413
cortez,381,31,0.003551156222911948,0.0006139343288311483,412
concept,4,408,3.7282480030571634e-05,0.008080167940745436,412
claim,326,86,0.003038522122491588,0.0017031726541767338,412
record,314,97,0.0029266746823998734,0.001921020319245851,411
‘diversity,410,1,0.0038214542031335926,1.9804333188101555e-05,411
welfare,330,80,0.00307580460252216,0.0015843466550481246,410
stage,383,27,0.003569797462927234,0.000534716996078742,410
illegals,381,28,0.003551156222911948,0.0005545213292668436,409
prison,341,68,0.0031783314226062316,0.0013466946567909058,409
veri,2,407,1.8641240015285817e-05,0.008060363607557334,409
losing,237,171,0.0022089869418113694,0.0033865409751653664,408
let,144,264,0.0013421692811005788,0.005228343961658811,408
home,208,199,0.001938688961589725,0.00394106230443221,407
noncompete,406,1,0.003784171723103021,1.9804333188101555e-05,407
lease,406,1,0.003784171723103021,1.9804333188101555e-05,407
tenants,406,1,0.003784171723103021,1.9804333188101555e-05,407
ocasio,377,30,0.0035138737428813765,0.0005941299956430467,407
envoy,1,405,9.320620007642909e-06,0.008020754941181131,406
george,348,58,0.003243575762659732,0.0011486513249098903,406
fan,402,3,0.003746889243072449,5.941299956430467e-05,405
center,355,48,0.0033088201027132325,0.0009506079930288747,403
please,269,134,0.0025072467820559424,0.0026537806472056087,403
false,44,358,0.000410107280336288,0.007089951281340357,402
announced,3,399,2.7961860022928726e-05,0.007901928942052522,402
doctor,400,2,0.0037282480030571634,3.960866637620311e-05,402
migrant,380,22,0.003541835602904305,0.00043569533013823424,402
murderer,389,12,0.0036257211829730913,0.0002376519982572187,401
scandal,129,271,0.0012023599809859351,0.005366974293975522,400
⁦,49,351,0.0004567103803745025,0.0069513209490236465,400
control,276,123,0.002572491122109443,0.0024359329821364915,399
planned,375,23,0.003495232502866091,0.0004554996633263358,398
always,115,283,0.0010718713008789345,0.00560462629223274,398
killed,366,32,0.0034113469227973043,0.0006337386620192498,398
levels,396,1,0.0036909655230265917,1.9804333188101555e-05,397
chairman,1,396,9.320620007642909e-06,0.007842515942488217,397
racist,147,249,0.0013701311411235075,0.004931278963837288,396
knew,209,187,0.0019480095815973678,0.003703410306174991,396
lies,155,241,0.0014446961011846508,0.004772844298332475,396
cory,369,27,0.0034393087828202334,0.000534716996078742,396
ice,291,104,0.0027123004222240864,0.002059650651562562,395
sjw,392,1,0.00365368304299602,1.9804333188101555e-05,393
fentanyl,352,40,0.003280858242690304,0.0007921733275240623,392
direct,2,389,1.8641240015285817e-05,0.007703885610171506,391
alone,14,377,0.00013048868010700072,0.007466233611914287,391
among,37,353,0.0003448629402827876,0.00699092961539985,390
birth,389,1,0.0036257211829730913,1.9804333188101555e-05,390
texting,1,389,9.320620007642909e-06,0.007703885610171506,390
makes,232,157,0.0021623838417731546,0.003109280310531944,389
research,385,2,0.00358843870294252,3.960866637620311e-05,387
30,151,235,0.001407413621154079,0.004654018299203866,386
refugee,379,6,0.003532514982896662,0.00011882599912860934,385
dummy,350,35,0.0032622170026750177,0.0006931516615835545,385
🤔,366,18,0.0034113469227973043,0.000356477997385828,384
anybody,366,17,0.0034113469227973043,0.00033667366419772645,383
aid,193,190,0.0017988796614750813,0.0037628233057392956,383
following,345,37,0.0032156139026368034,0.0007327603279597576,382
look,239,143,0.002227628181826655,0.0028320196458985225,382
marine,363,19,0.0033833850627743756,0.0003762823305739296,382
gas,338,44,0.003150369562583303,0.0008713906602764685,382
shes,207,175,0.001929368341582082,0.003465758307917772,382
driving,377,5,0.0035138737428813765,9.902166594050779e-05,382
tickets,362,19,0.003374064442766733,0.0003762823305739296,381
burger,366,14,0.0034113469227973043,0.0002772606646334218,380
week,53,327,0.0004939928604050742,0.006476016952509209,380
hunter,1,378,9.320620007642909e-06,0.007486037945102389,379
spouses,377,1,0.0035138737428813765,1.9804333188101555e-05,378
rule,13,363,0.00012116806009935781,0.007188972947280865,376
forget,319,56,0.0029732777824380877,0.0011090426585336872,375
whatdoyouthink,374,1,0.0034859118828584478,1.9804333188101555e-05,375
fire,224,150,0.0020878188817120115,0.0029706499782152333,374
services,340,33,0.003169010802598589,0.0006535429952073513,373
appalling,3,370,2.7961860022928726e-05,0.007327603279597576,373
committing,90,283,0.0008388558006878617,0.00560462629223274,373
rejects,278,95,0.0025911323621247285,0.0018814116528696478,373
drops,315,58,0.002935995302407516,0.0011486513249098903,373
sent,16,356,0.00014912992012228654,0.0070503426149641545,372
awesome,330,42,0.00307580460252216,0.0008317819939002653,372
anything,62,310,0.0005778784404738603,0.0061393432883114826,372
weak,352,19,0.003280858242690304,0.0003762823305739296,371
man”,369,2,0.0034393087828202334,3.960866637620311e-05,371
womens,287,84,0.0026750179421935146,0.0016635639878005307,371
hed,193,177,0.0017988796614750813,0.0035053669742939756,370
presidents,162,208,0.0015099404412381512,0.004119301303125124,370
oh,239,131,0.002227628181826655,0.002594367647641304,370
40,337,33,0.0031410489425756603,0.0006535429952073513,370
islamic,361,8,0.00336474382275909,0.00015843466550481244,369
costs,352,17,0.003280858242690304,0.00033667366419772645,369
servant,1,368,9.320620007642909e-06,0.007287994613221373,369
used,155,214,0.0014446961011846508,0.004238127302253733,369
saudi,46,323,0.0004287485203515738,0.006396799619756803,369
moscow,1,367,9.320620007642909e-06,0.007268190280033272,368
period,364,4,0.0033927056827820186,7.921733275240622e-05,368
doj,57,311,0.0005312753404356458,0.006159147621499584,368
french,366,2,0.0034113469227973043,3.960866637620311e-05,368
pew,366,2,0.0034113469227973043,3.960866637620311e-05,368
nba,364,3,0.0033927056827820186,5.941299956430467e-05,367
drunk,365,2,0.0034020263027896617,3.960866637620311e-05,367
twice,322,45,0.0030012396424610164,0.00089119499346457,367
working,192,175,0.0017895590414674385,0.003465758307917772,367
whistle,2,365,1.8641240015285817e-05,0.007228581613657068,367
sales,349,17,0.003252896382667375,0.00033667366419772645,366
alarmed,1,365,9.320620007642909e-06,0.007228581613657068,366
intend,358,7,0.0033367819627361612,0.0001386303323167109,365
filled,6,359,5.592372004585745e-05,0.007109755614528459,365
adam,2,363,1.8641240015285817e-05,0.007188972947280865,365
swells,363,1,0.0033833850627743756,1.9804333188101555e-05,364
zion,362,1,0.003374064442766733,1.9804333188101555e-05,363
drawn,361,2,0.00336474382275909,3.960866637620311e-05,363
dan,303,60,0.002824147862315801,0.0011882599912860935,363
selling,353,10,0.003290178862697947,0.00019804333188101558,363
writes,300,62,0.0027961860022928725,0.0012278686576622966,362
overall,360,2,0.003355423202751447,3.960866637620311e-05,362
introduce,303,59,0.002824147862315801,0.0011684556580979918,362
heart,277,85,0.0025818117421170855,0.0016833683209886323,362
williamsons,361,1,0.00336474382275909,1.9804333188101555e-05,362
browns,361,1,0.00336474382275909,1.9804333188101555e-05,362
possible,66,295,0.0006151609205044319,0.00584227829048996,361
b,54,307,0.000503313480412717,0.006079930288747178,361
fact,51,310,0.0004753516203897883,0.0061393432883114826,361
jobs,330,30,0.00307580460252216,0.0005941299956430467,360
little,295,65,0.002749582902254658,0.0012872816572266012,360
order,285,75,0.002656376702178229,0.0014853249891076167,360
pages,349,11,0.003252896382667375,0.00021784766506911712,360
mueller,134,225,0.0012489630810241497,0.00445597496732285,359
agents,204,155,0.0019014064815591532,0.0030696716441557413,359
levin,358,1,0.0033367819627361612,1.9804333188101555e-05,359
deadline,33,324,0.00030758046025221596,0.006416603952944904,357
penny,356,1,0.0033181407227208756,1.9804333188101555e-05,357
democracy,6,350,5.592372004585745e-05,0.006931516615835544,356
dark,141,215,0.0013142074210776501,0.004257931635441835,356
supreme,2,354,1.8641240015285817e-05,0.007010733948587951,356
article,210,144,0.0019573302016050106,0.002851823979086624,354
read,217,137,0.002022574541658511,0.0027131936467699133,354
deep,285,69,0.002656376702178229,0.0013664989899790075,354
phone,2,351,1.8641240015285817e-05,0.0069513209490236465,353
cost,204,149,0.0019014064815591532,0.002950845645027132,353
students,274,79,0.002553849882094157,0.001564542321860023,353
fight,177,176,0.0016497497413527947,0.003485562641105874,353
amid,46,306,0.0004287485203515738,0.006060125955559077,352
wh,17,335,0.00015845054012992945,0.0066344516180140214,352
tuesday,299,53,0.0027868653822852294,0.0010496296589693826,352
kavanaugh,2,350,1.8641240015285817e-05,0.006931516615835544,352
funding,302,49,0.002814827242308158,0.0009704123262169763,351
transgender,329,22,0.003066483982514517,0.00043569533013823424,351
infant,349,2,0.003252896382667375,3.960866637620311e-05,351
senior,2,349,1.8641240015285817e-05,0.006911712282647443,351
interfered,1,349,9.320620007642909e-06,0.006911712282647443,350
idea,193,157,0.0017988796614750813,0.003109280310531944,350
dem,52,298,0.00048467224039743125,0.005901691290054264,350
constitution,221,129,0.002059857021689083,0.0025547589812651007,350
christians,346,4,0.0032249345226444464,7.921733275240622e-05,350
intellectual,348,1,0.003243575762659732,1.9804333188101555e-05,349
mom,320,29,0.0029825984024457308,0.0005743256624549452,349
willed,348,1,0.003243575762659732,1.9804333188101555e-05,349
‘patrioticshut,348,1,0.003243575762659732,1.9804333188101555e-05,349
recalled,1,347,9.320620007642909e-06,0.00687210361627124,348
nations,189,159,0.0017615971814445098,0.0031488889769081476,348
clearly,298,49,0.002777544762277587,0.0009704123262169763,347
launches,335,12,0.0031224077025603742,0.0002376519982572187,347
pedophile,346,1,0.0032249345226444464,1.9804333188101555e-05,347
enters,345,2,0.0032156139026368034,3.960866637620311e-05,347
turns,102,245,0.0009507032407795766,0.004852061631084882,347
wow,182,165,0.0016963528413910093,0.0032677149760367567,347
sports,345,1,0.0032156139026368034,1.9804333188101555e-05,346
hit,290,56,0.0027029798022164433,0.0011090426585336872,346
raises,106,240,0.0009879857208101484,0.004753039965144374,346
buttigieg,313,32,0.0029173540623922303,0.0006337386620192498,345
thousands,300,45,0.0027961860022928725,0.00089119499346457,345
technology,343,2,0.0031969726626215177,3.960866637620311e-05,345
mccabe,1,343,9.320620007642909e-06,0.006792886283518834,344
number,198,146,0.0018454827615132958,0.002891432645462827,344
cheese,342,1,0.0031876520426138747,1.9804333188101555e-05,343
considering,10,333,9.320620007642909e-05,0.006594842951637818,343
wearing,285,58,0.002656376702178229,0.0011486513249098903,343
controversy,1,340,9.320620007642909e-06,0.006733473283954529,341
congressional,5,335,4.660310003821454e-05,0.0066344516180140214,340
fair,280,60,0.002609773602140014,0.0011882599912860935,340
maze,339,1,0.003159690182590946,1.9804333188101555e-05,340
angry,26,314,0.00024233612019871562,0.006218560621063888,340
trials,338,1,0.003150369562583303,1.9804333188101555e-05,339
fun,336,3,0.0031317283225680173,5.941299956430467e-05,339
exit,338,1,0.003150369562583303,1.9804333188101555e-05,339
future,299,39,0.0027868653822852294,0.0007723689943359607,338
billionaires,322,16,0.0030012396424610164,0.0003168693310096249,338
baltimore,335,2,0.0031224077025603742,3.960866637620311e-05,337
murder,284,51,0.002647056082170586,0.0010100209925931795,335
running,93,242,0.0008668176607107905,0.004792648631520576,335
alligators,109,226,0.001015947580833077,0.004475779300510952,335
chief,67,267,0.0006244815405120748,0.005287756961223115,334
front,170,164,0.0015845054012992945,0.003247910642848655,334
instead,163,171,0.001519261061245794,0.0033865409751653664,334
challenge,290,43,0.0027029798022164433,0.0008515863270883669,333
pete,311,22,0.0028987128223769447,0.00043569533013823424,333
kurt,3,330,2.7961860022928726e-05,0.0065354299520735135,333
according,262,70,0.002442002442002442,0.001386303323167109,332
water,6,325,5.592372004585745e-05,0.0064364082861330055,331
rapists,330,1,0.00307580460252216,1.9804333188101555e-05,331
ag,69,262,0.0006431227805273607,0.005188735295282608,331
dame,330,1,0.00307580460252216,1.9804333188101555e-05,331
kids,276,55,0.002572491122109443,0.0010892383253455855,331
outlet,295,36,0.002749582902254658,0.000712955994771656,331
saying,98,233,0.000913420760749005,0.0046144096328276625,331
citizenship,311,19,0.0028987128223769447,0.0003762823305739296,330
notre,329,1,0.003066483982514517,1.9804333188101555e-05,330
special,82,248,0.0007642908406267185,0.004911474630649186,330
co,189,141,0.0017615971814445098,0.0027924109795223195,330
murderers,328,1,0.003057163362506874,1.9804333188101555e-05,329
concerns,1,328,9.320620007642909e-06,0.00649582128569731,329
sucks,300,29,0.0027961860022928725,0.0005743256624549452,329
helping,274,55,0.002553849882094157,0.0010892383253455855,329
rally,162,167,0.0015099404412381512,0.00330732364241296,329
200,321,6,0.002991919022453374,0.00011882599912860934,327
website,321,6,0.002991919022453374,0.00011882599912860934,327
power,166,161,0.0015472229212687228,0.0031884976432843505,327
brian,322,4,0.0030012396424610164,7.921733275240622e-05,326
publicly,5,321,4.660310003821454e-05,0.0063571909533806,326
names,5,321,4.660310003821454e-05,0.0063571909533806,326
wage,323,3,0.0030105602624686595,5.941299956430467e-05,326
ass,122,204,0.001137115640932435,0.004040083970372718,326
takes,298,27,0.002777544762277587,0.000534716996078742,325
macron,321,3,0.002991919022453374,5.941299956430467e-05,324
british,89,235,0.0008295351806802189,0.004654018299203866,324
guns,271,52,0.002525888022071228,0.001029825325781281,323
pence,2,321,1.8641240015285817e-05,0.0063571909533806,323
making,37,286,0.0003448629402827876,0.005664039291797045,323
jail,311,11,0.0028987128223769447,0.00021784766506911712,322
include,288,34,0.0026843385622011577,0.0006733473283954529,322
emmanuel,321,1,0.002991919022453374,1.9804333188101555e-05,322
fourth,308,13,0.002870750962354016,0.00025745633144532023,321
talking,216,105,0.002013253921650868,0.0020794549847506635,321
build,239,82,0.002227628181826655,0.0016239553214243275,321
repair,320,1,0.0029825984024457308,1.9804333188101555e-05,321
apprenticeship,319,1,0.0029732777824380877,1.9804333188101555e-05,320
bid,1,318,9.320620007642909e-06,0.006297777953816295,319
based,239,80,0.002227628181826655,0.0015843466550481246,319
air,80,237,0.0007456496006114327,0.004693626965580069,317
tech,316,1,0.002945315922415159,1.9804333188101555e-05,317
criticism,265,52,0.0024699643020253707,0.001029825325781281,317
politics,10,307,9.320620007642909e-05,0.006079930288747178,317
speaking,23,293,0.0002143742601757869,0.005802669624113756,316
theres,108,208,0.001006626960825434,0.004119301303125124,316
plain,4,312,3.7282480030571634e-05,0.006178951954687686,316
nbc,3,313,2.7961860022928726e-05,0.006198756287875787,316
31,297,19,0.0027682241422699438,0.0003762823305739296,316
minimum,312,4,0.0029080334423845873,7.921733275240622e-05,316
soon,200,115,0.0018641240015285817,0.002277498316631679,315
hear,142,173,0.001323528041085293,0.0034261496415415693,315
seize,312,2,0.0029080334423845873,3.960866637620311e-05,314
wear,227,87,0.0021157807417349402,0.0017229769873648355,314
plans,109,205,0.001015947580833077,0.004059888303560819,314
track,308,6,0.002870750962354016,0.00011882599912860934,314
representing,1,313,9.320620007642909e-06,0.006198756287875787,314
164k,313,1,0.0029173540623922303,1.9804333188101555e-05,314
reforms,1,313,9.320620007642909e-06,0.006198756287875787,314
183k,313,1,0.0029173540623922303,1.9804333188101555e-05,314
broken,218,96,0.002031895161666154,0.0019012159860577495,314
gov,302,11,0.002814827242308158,0.00021784766506911712,313
5th,296,17,0.0027589035222623007,0.00033667366419772645,313
bringing,100,212,0.0009320620007642909,0.00419851863587753,312
worked,11,301,0.000102526820084072,0.005961104289618569,312
thinks,229,83,0.002134421981750226,0.0016437596546124292,312
64,258,53,0.0024047199619718703,0.0010496296589693826,311
articles,294,16,0.002740262282247015,0.0003168693310096249,310
name,186,124,0.001733635321421581,0.002455737315324593,310
polls,261,49,0.002432681821994799,0.0009704123262169763,310
bullst,309,1,0.0028800715823616586,1.9804333188101555e-05,310
rapist,308,1,0.002870750962354016,1.9804333188101555e-05,309
threatened,200,109,0.0018641240015285817,0.0021586723175030698,309
fakery,308,1,0.002870750962354016,1.9804333188101555e-05,309
guru,308,1,0.002870750962354016,1.9804333188101555e-05,309
account,12,296,0.0001118474400917149,0.005862082623678061,308
universe,307,1,0.002861430342346373,1.9804333188101555e-05,308
helped,6,302,5.592372004585745e-05,0.00598090862280667,308
notion,4,303,3.7282480030571634e-05,0.006000712955994771,307
sending,296,10,0.0027589035222623007,0.00019804333188101558,306
parents,282,24,0.0026284148421553003,0.0004753039965144374,306
drafted,1,304,9.320620007642909e-06,0.006020517289182873,305
five,250,55,0.002330155001910727,0.0010892383253455855,305
putin,156,149,0.0014540167211922936,0.002950845645027132,305
athletes,304,1,0.002833468482323444,1.9804333188101555e-05,305
snakes,3,302,2.7961860022928726e-05,0.00598090862280667,305
detached,1,303,9.320620007642909e-06,0.006000712955994771,304
realityala,1,303,9.320620007642909e-06,0.006000712955994771,304
shooting,125,179,0.0011650775009553636,0.0035449756406701785,304
veilwhat,303,1,0.002824147862315801,1.9804333188101555e-05,304
advanced,1,303,9.320620007642909e-06,0.006000712955994771,304
alternate,303,1,0.002824147862315801,1.9804333188101555e-05,304
urged,1,302,9.320620007642909e-06,0.00598090862280667,303
produce,15,288,0.00013980930011464363,0.005703647958173248,303
movie,292,11,0.0027216210422317294,0.00021784766506911712,303
video,213,89,0.0019852920616279393,0.0017625856537410386,302
island,271,31,0.002525888022071228,0.0006139343288311483,302
theory,5,297,4.660310003821454e-05,0.005881886956866162,302
body,295,7,0.002749582902254658,0.0001386303323167109,302
criminalizing,301,1,0.0028055066223005155,1.9804333188101555e-05,302
lawsuit,94,207,0.0008761382807184334,0.004099496969937022,301
food,207,94,0.001929368341582082,0.0018616073196815464,301
exposed,270,30,0.0025165674020635855,0.0005941299956430467,300
dept,210,90,0.0019573302016050106,0.00178238998692914,300
town,259,41,0.0024140405819795133,0.0008119776607121638,300
oversight,2,298,1.8641240015285817e-05,0.005901691290054264,300
australian,1,299,9.320620007642909e-06,0.005921495623242365,300
cbs,267,31,0.0024886055420406564,0.0006139343288311483,298
heres,88,210,0.000820214560672576,0.004158909969501327,298
scoop,1,296,9.320620007642909e-06,0.005862082623678061,297
consecutive,295,1,0.002749582902254658,1.9804333188101555e-05,296
sexual,273,23,0.002544529262086514,0.0004554996633263358,296
300,295,1,0.002749582902254658,1.9804333188101555e-05,296
homicides,295,1,0.002749582902254658,1.9804333188101555e-05,296
parenthood,294,2,0.002740262282247015,3.960866637620311e-05,296
female,295,1,0.002749582902254658,1.9804333188101555e-05,296
2030,294,1,0.002740262282247015,1.9804333188101555e-05,295
prices,287,8,0.0026750179421935146,0.00015843466550481244,295
finland,294,1,0.002740262282247015,1.9804333188101555e-05,295
rather,268,26,0.0024979261620482994,0.0005149126628906405,294
unguarded,293,1,0.002730941662239372,1.9804333188101555e-05,294
true,109,184,0.001015947580833077,0.0036439973066106864,293
corruption,62,231,0.0005778784404738603,0.004574800966451459,293
north,156,136,0.0014540167211922936,0.0026933893135818116,292
children,249,43,0.002320834381903084,0.0008515863270883669,292
seen,85,207,0.0007922527006496473,0.004099496969937022,292
seems,48,244,0.0004473897603668596,0.00483225729789678,292
picture,283,9,0.002637735462162943,0.000178238998692914,292
ex,17,274,0.00015845054012992945,0.0054263872935398265,291
threatening,241,50,0.002246269421841941,0.0009902166594050778,291
covered,251,40,0.00233947562191837,0.0007921733275240623,291
truth,185,106,0.001724314701413938,0.002099259317938765,291
hickenlooper,1,290,9.320620007642909e-06,0.005743256624549452,291
50,210,81,0.0019573302016050106,0.001604150988236226,291
nolte,290,1,0.0027029798022164433,1.9804333188101555e-05,291
exclusive,182,108,0.0016963528413910093,0.002138867984314968,290
crazy,44,246,0.000410107280336288,0.004871865964272983,290
removal,7,283,6.524434005350036e-05,0.00560462629223274,290
graham,15,275,0.00013980930011464363,0.005446191626727928,290
500,201,88,0.0018734446215362245,0.001742781320552937,289
colleagues,1,287,9.320620007642909e-06,0.005683843624985147,288
stupid,261,27,0.002432681821994799,0.000534716996078742,288
comprehensive,285,3,0.002656376702178229,5.941299956430467e-05,288
beautiful,285,3,0.002656376702178229,5.941299956430467e-05,288
unearthed,1,286,9.320620007642909e-06,0.005664039291797045,287
reporting,30,257,0.00027961860022928726,0.0050897136293421,287
personality,285,1,0.002656376702178229,1.9804333188101555e-05,286
acting,18,268,0.00016777116013757235,0.005307561294411217,286
quirks,285,1,0.002656376702178229,1.9804333188101555e-05,286
part,110,176,0.00102526820084072,0.003485562641105874,286
camp,244,41,0.00227423128186487,0.0008119776607121638,285
colorado,59,226,0.0005499165804509316,0.004475779300510952,285
religious,173,112,0.0016124672613222232,0.0022180853170673744,285
received,6,279,5.592372004585745e-05,0.0055254089594803345,285
single,188,97,0.0017522765614368667,0.001921020319245851,285
economics,283,1,0.002637735462162943,1.9804333188101555e-05,284
pressure,10,274,9.320620007642909e-05,0.0054263872935398265,284
backfired,1,283,9.320620007642909e-06,0.00560462629223274,284
terrorists,194,90,0.0018082002814827243,0.00178238998692914,284
attacks,89,195,0.0008295351806802189,0.0038618449716798036,284
grave,167,116,0.0015565435412763656,0.0022973026498197806,283
person,142,141,0.001323528041085293,0.0027924109795223195,283
ought,3,280,2.7961860022928726e-05,0.005545213292668436,283
texts,1,281,9.320620007642909e-06,0.005565017625856538,282
endangered,38,244,0.0003541835602904305,0.00483225729789678,282
trench,1,281,9.320620007642909e-06,0.005565017625856538,282
past,128,154,0.0011930393609782923,0.0030498673109676396,282
district,13,268,0.00012116806009935781,0.005307561294411217,281
pretty,216,65,0.002013253921650868,0.0012872816572266012,281
learn,26,255,0.00024233612019871562,0.005050104962965897,281
rachel,278,2,0.0025911323621247285,3.960866637620311e-05,280
cop,275,5,0.0025631705021018,9.902166594050779e-05,280
degree,278,2,0.0025911323621247285,3.960866637620311e-05,280
solution,277,3,0.0025818117421170855,5.941299956430467e-05,280
connection,155,125,0.0014446961011846508,0.0024755416485126944,280
defense,257,23,0.0023953993419642276,0.0004554996633263358,280
jersey,277,2,0.0025818117421170855,3.960866637620311e-05,279
retire,276,3,0.002572491122109443,5.941299956430467e-05,279
maddow,276,3,0.002572491122109443,5.941299956430467e-05,279
weightlifting,277,1,0.0025818117421170855,1.9804333188101555e-05,278
collusion,170,108,0.0015845054012992945,0.002138867984314968,278
unless,272,6,0.002535208642078871,0.00011882599912860934,278
restricted,197,81,0.001836162141505653,0.001604150988236226,278
‘i,266,12,0.0024792849220330137,0.0002376519982572187,278
hillary,70,208,0.0006524434005350035,0.004119301303125124,278
brothers,276,2,0.002572491122109443,3.960866637620311e-05,278
rules,51,227,0.0004753516203897883,0.004495583633699053,278
daring,2,276,1.8641240015285817e-05,0.00546599595991603,278
cair,277,1,0.0025818117421170855,1.9804333188101555e-05,278
invasion,172,106,0.0016031466413145802,0.002099259317938765,278
small,262,16,0.002442002442002442,0.0003168693310096249,278
msnbc,274,3,0.002553849882094157,5.941299956430467e-05,277
july,128,149,0.0011930393609782923,0.002950845645027132,277
recent,49,228,0.0004567103803745025,0.004515387966887155,277
birds,239,38,0.002227628181826655,0.0007525646611478592,277
involved,131,146,0.001221001221001221,0.002891432645462827,277
80,228,48,0.0021251013617425833,0.0009506079930288747,276
billionaire,272,4,0.002535208642078871,7.921733275240622e-05,276
returns,6,269,5.592372004585745e-05,0.005327365627599319,275
near,178,97,0.0016590703613604378,0.001921020319245851,275
troops,66,209,0.0006151609205044319,0.004139105636313226,275
👇❌👇❌👇❌👇kamala,273,1,0.002544529262086514,1.9804333188101555e-05,274
era,266,8,0.0024792849220330137,0.00015843466550481244,274
robert,5,269,4.660310003821454e-05,0.005327365627599319,274
fictional,261,13,0.002432681821994799,0.00025745633144532023,274
points,224,49,0.0020878188817120115,0.0009704123262169763,273
migration,272,1,0.002535208642078871,1.9804333188101555e-05,273
frustrates,1,272,9.320620007642909e-06,0.005386778627163623,273
newsom,263,9,0.002451323062010085,0.000178238998692914,272
league,271,1,0.002525888022071228,1.9804333188101555e-05,272
spent,197,74,0.001836162141505653,0.0014655206559195152,271
intriguing,2,269,1.8641240015285817e-05,0.005327365627599319,271
computer,257,14,0.0023953993419642276,0.0002772606646334218,271
plot,264,7,0.0024606436820177277,0.0001386303323167109,271
parts,221,49,0.002059857021689083,0.0009704123262169763,270
alabama,239,31,0.002227628181826655,0.0006139343288311483,270
tweet,208,62,0.001938688961589725,0.0012278686576622966,270
promises,210,60,0.0019573302016050106,0.0011882599912860935,270
whos,241,29,0.002246269421841941,0.0005743256624549452,270
silence,40,229,0.00037282480030571634,0.004535192300075257,269
basing,261,8,0.002432681821994799,0.00015843466550481244,269
healthy,260,8,0.0024233612019871563,0.00015843466550481244,268
access,34,234,0.0003169010802598589,0.004634213966015765,268
free,131,136,0.001221001221001221,0.0026933893135818116,267
generals,2,265,1.8641240015285817e-05,0.005248148294846913,267
lady,260,7,0.0024233612019871563,0.0001386303323167109,267
assault,184,82,0.0017149940814062952,0.0016239553214243275,266
win,108,158,0.001006626960825434,0.003129084643720046,266
dripdripdrip,1,265,9.320620007642909e-06,0.005248148294846913,266
appear,48,218,0.0004473897603668596,0.0043173446350061396,266
stocked,1,265,9.320620007642909e-06,0.005248148294846913,266
attacked,257,8,0.0023953993419642276,0.00015843466550481244,265
victims,255,10,0.0023767581019489416,0.00019804333188101558,265
inquiry,1,264,9.320620007642909e-06,0.005228343961658811,265
cut,234,31,0.0021810250817884407,0.0006139343288311483,265
mavericks,263,1,0.002451323062010085,1.9804333188101555e-05,264
nowitzkis,263,1,0.002451323062010085,1.9804333188101555e-05,264
finds,167,97,0.0015565435412763656,0.001921020319245851,264
surpass,261,3,0.002432681821994799,5.941299956430467e-05,264
dirk,263,1,0.002451323062010085,1.9804333188101555e-05,264
49,261,3,0.002432681821994799,5.941299956430467e-05,264
unaware,263,1,0.002451323062010085,1.9804333188101555e-05,264
schultz,262,1,0.002442002442002442,1.9804333188101555e-05,263
practically,5,258,4.660310003821454e-05,0.005109517962530201,263
hard,106,157,0.0009879857208101484,0.003109280310531944,263
host,230,33,0.002143742601757869,0.0006535429952073513,263
owens,262,1,0.002442002442002442,1.9804333188101555e-05,263
candace,261,1,0.002432681821994799,1.9804333188101555e-05,262
busts,261,1,0.002432681821994799,1.9804333188101555e-05,262
abuse,135,127,0.0012582837010317927,0.002515150314888898,262
gavin,260,2,0.0024233612019871563,3.960866637620311e-05,262
hong,14,248,0.00013048868010700072,0.004911474630649186,262
tweeted,155,106,0.0014446961011846508,0.002099259317938765,261
italy,245,16,0.0022835519018725124,0.0003168693310096249,261
nra,11,250,0.000102526820084072,0.004951083297025389,261
sight,1,259,9.320620007642909e-06,0.0051293222957183035,260
lawyer,49,211,0.0004567103803745025,0.004178714302689428,260
solicitin,1,258,9.320620007642909e-06,0.005109517962530201,259
birthright,258,1,0.0024047199619718703,1.9804333188101555e-05,259
around,98,161,0.000913420760749005,0.0031884976432843505,259
omars,257,1,0.0023953993419642276,1.9804333188101555e-05,258
combative,1,257,9.320620007642909e-06,0.0050897136293421,258
restaurant,256,2,0.0023860787219565846,3.960866637620311e-05,258
impeaching,1,257,9.320620007642909e-06,0.0050897136293421,258
ivanka,11,246,0.000102526820084072,0.004871865964272983,257
disclosed,1,256,9.320620007642909e-06,0.005069909296153998,257
appeal,149,108,0.0013887723811387934,0.002138867984314968,257
garbage,248,9,0.002311513761895441,0.000178238998692914,257
bunch,201,56,0.0018734446215362245,0.0011090426585336872,257
trip,71,185,0.0006617640205426465,0.003663801639798788,256
exists,245,11,0.0022835519018725124,0.00021784766506911712,256
position,215,41,0.0020039333016432254,0.0008119776607121638,256
lest,255,1,0.0023767581019489416,1.9804333188101555e-05,256
thank,203,52,0.0018920858615515104,0.001029825325781281,255
months,40,215,0.00037282480030571634,0.004257931635441835,255
remains,246,9,0.0022928725218801555,0.000178238998692914,255
ron,251,4,0.00233947562191837,7.921733275240622e-05,255
daughter,57,197,0.0005312753404356458,0.0039014536380560065,254
6,156,98,0.0014540167211922936,0.0019408246524339526,254
quite,198,55,0.0018454827615132958,0.0010892383253455855,253
might,128,125,0.0011930393609782923,0.0024755416485126944,253
buildthatwall,252,1,0.002348796241926013,1.9804333188101555e-05,253
r,45,207,0.00041942790034393086,0.004099496969937022,252
promised,8,244,7.456496006114327e-05,0.00483225729789678,252
p,18,233,0.00016777116013757235,0.0046144096328276625,251
2nd,88,163,0.000820214560672576,0.003228106309660554,251
whic,2,249,1.8641240015285817e-05,0.004931278963837288,251
donor,183,68,0.0017056734613986521,0.0013466946567909058,251
reaganbushclintonwbushampobama,1,249,9.320620007642909e-06,0.004931278963837288,250
global,230,20,0.002143742601757869,0.00039608666376203115,250
circ,1,249,9.320620007642909e-06,0.004931278963837288,250
governor,28,222,0.00026097736021400144,0.004396561967758545,250
dc,120,130,0.001118474400917149,0.0025745633144532024,250
rudy,43,207,0.00040078666032864504,0.004099496969937022,250
pl,211,39,0.0019666508216126537,0.0007723689943359607,250
inspector,1,249,9.320620007642909e-06,0.004931278963837288,250
couple,229,21,0.002134421981750226,0.00041589099695013267,250
khans,249,1,0.002320834381903084,1.9804333188101555e-05,250
hottest,200,50,0.0018641240015285817,0.0009902166594050778,250
accuse,217,33,0.002022574541658511,0.0006535429952073513,250
members,37,213,0.0003448629402827876,0.004218322969065632,250
wasnt,22,227,0.000205053640168144,0.004495583633699053,249
plants,191,58,0.0017802384214597954,0.0011486513249098903,249
michael,3,246,2.7961860022928726e-05,0.004871865964272983,249
gang,218,31,0.002031895161666154,0.0006139343288311483,249
demand,156,92,0.0014540167211922936,0.0018219986533053432,248
complains,245,3,0.0022835519018725124,5.941299956430467e-05,248
communism,246,2,0.0022928725218801555,3.960866637620311e-05,248
species,7,241,6.524434005350036e-05,0.004772844298332475,248
homeland,109,138,0.001015947580833077,0.002732997979958015,247
push,115,132,0.0010718713008789345,0.0026141719808294053,247
fraud,50,197,0.00046603100038214543,0.0039014536380560065,247
tired,229,17,0.002134421981750226,0.00033667366419772645,246
everyone,161,85,0.0015006198212305082,0.0016833683209886323,246
scheme,174,72,0.001621787881329866,0.001425911989543312,246
howard,244,1,0.00227423128186487,1.9804333188101555e-05,245
worried,231,14,0.002153063221765512,0.0002772606646334218,245
foreigners,244,1,0.00227423128186487,1.9804333188101555e-05,245
showing,223,22,0.0020784982617043685,0.00043569533013823424,245
starbucks,242,2,0.0022555900418495837,3.960866637620311e-05,244
lefts,6,238,5.592372004585745e-05,0.0047134312987681705,244
conspirators,241,2,0.002246269421841941,3.960866637620311e-05,243
cia,19,224,0.00017709178014521526,0.004436170634134749,243
text,1,242,9.320620007642909e-06,0.004792648631520576,243
bad,104,138,0.0009693444807948625,0.002732997979958015,242
fries,241,1,0.002246269421841941,1.9804333188101555e-05,242
alert,171,70,0.0015938260213069373,0.001386303323167109,241
shared,3,238,2.7961860022928726e-05,0.0047134312987681705,241
weekend,188,53,0.0017522765614368667,0.0010496296589693826,241
supporters,192,49,0.0017895590414674385,0.0009704123262169763,241
steamed,240,1,0.002236948801834298,1.9804333188101555e-05,241
legally,6,234,5.592372004585745e-05,0.004634213966015765,240
kong,14,226,0.00013048868010700072,0.004475779300510952,240
third,151,89,0.001407413621154079,0.0017625856537410386,240
numbnut,239,1,0.002227628181826655,1.9804333188101555e-05,240
spouting,239,1,0.002227628181826655,1.9804333188101555e-05,240
shut,179,61,0.0016683909813680806,0.001208064324474195,240
final,236,4,0.0021996663218037263,7.921733275240622e-05,240
yellow,239,1,0.002227628181826655,1.9804333188101555e-05,240
impeachable,1,239,9.320620007642909e-06,0.004733235631956272,240
rhode,239,1,0.002227628181826655,1.9804333188101555e-05,240
burisma,1,238,9.320620007642909e-06,0.0047134312987681705,239
cops,208,31,0.001938688961589725,0.0006139343288311483,239
ed,196,43,0.00182684152149801,0.0008515863270883669,239
eu,192,46,0.0017895590414674385,0.0009109993266526716,238
low,91,147,0.0008481764206955047,0.0029112369786509287,238
‘legitimate,237,1,0.0022089869418113694,1.9804333188101555e-05,238
major,67,171,0.0006244815405120748,0.0033865409751653664,238
respond,230,8,0.002143742601757869,0.00015843466550481244,238
descends,1,237,9.320620007642909e-06,0.004693626965580069,238
andrew,20,218,0.00018641240015285817,0.0043173446350061396,238
falls,223,14,0.0020784982617043685,0.0002772606646334218,237
stopped,228,9,0.0021251013617425833,0.000178238998692914,237
afraid,45,192,0.00041942790034393086,0.003802431972115499,237
2000,165,72,0.00153790230126108,0.001425911989543312,237
protests,2,235,1.8641240015285817e-05,0.004654018299203866,237
jeanine,235,1,0.0021903457017960833,1.9804333188101555e-05,236
candid,235,1,0.0021903457017960833,1.9804333188101555e-05,236
sanderstownhall,235,1,0.0021903457017960833,1.9804333188101555e-05,236
reports,54,182,0.000503313480412717,0.0036043886402344835,236
jihad,235,1,0.0021903457017960833,1.9804333188101555e-05,236
warn,149,86,0.0013887723811387934,0.0017031726541767338,235
proof,137,98,0.0012769249410470784,0.0019408246524339526,235
laying,234,1,0.0021810250817884407,1.9804333188101555e-05,235
c,120,114,0.001118474400917149,0.0022576939834435773,234
investigating,35,199,0.0003262217002675018,0.00394106230443221,234
stronghold,233,1,0.0021717044617807976,1.9804333188101555e-05,234
‘behind,233,1,0.0021717044617807976,1.9804333188101555e-05,234
morning,6,228,5.592372004585745e-05,0.004515387966887155,234
xi,1,233,9.320620007642909e-06,0.0046144096328276625,234
‘true,233,1,0.0021717044617807976,1.9804333188101555e-05,234
depraved,232,1,0.0021623838417731546,1.9804333188101555e-05,233
dynamic,230,3,0.002143742601757869,5.941299956430467e-05,233
inappropriately,232,1,0.0021623838417731546,1.9804333188101555e-05,233
lawyers,64,169,0.0005965196804891462,0.003346932308789163,233
jump,228,5,0.0021251013617425833,9.902166594050779e-05,233
destroyed,228,4,0.0021251013617425833,7.921733275240622e-05,232
prompted,1,231,9.320620007642909e-06,0.004574800966451459,232
reportedly,82,150,0.0007642908406267185,0.0029706499782152333,232
become,138,94,0.0012862455610547214,0.0018616073196815464,232
urging,26,206,0.00024233612019871562,0.00407969263674892,232
likes,229,3,0.002134421981750226,5.941299956430467e-05,232
nyc,165,67,0.00153790230126108,0.0013268903236028043,232
ocean,121,111,0.0011277950209247919,0.0021982809838792727,232
agile,230,1,0.002143742601757869,1.9804333188101555e-05,231
cernovich,230,1,0.002143742601757869,1.9804333188101555e-05,231
pres,16,215,0.00014912992012228654,0.004257931635441835,231
2a,227,4,0.0021157807417349402,7.921733275240622e-05,231
lets,153,77,0.001426054861169365,0.0015249336554838198,230
full,117,113,0.0010905125408942203,0.002237889650255476,230
contact,1,229,9.320620007642909e-06,0.004535192300075257,230
four,179,51,0.0016683909813680806,0.0010100209925931795,230
nancy,192,37,0.0017895590414674385,0.0007327603279597576,229
vowing,1,228,9.320620007642909e-06,0.004515387966887155,229
question,56,172,0.0005219547204280029,0.0034063453083534676,228
repeatedly,15,213,0.00013980930011464363,0.004218322969065632,228
cockfight,227,1,0.0021157807417349402,1.9804333188101555e-05,228
confirmed,8,219,7.456496006114327e-05,0.004337148968194241,227
alveda,226,1,0.002106460121727297,1.9804333188101555e-05,227
ukrainian😂,1,226,9.320620007642909e-06,0.004475779300510952,227
university🤔🤔🤔🤔🤔wednesdaythoughts,226,1,0.002106460121727297,1.9804333188101555e-05,227
rips,214,13,0.0019946126816355824,0.00025745633144532023,227
obstructed,1,226,9.320620007642909e-06,0.004475779300510952,227
together,9,217,8.388558006878618e-05,0.0042975403018180374,226
protect,95,131,0.0008854589007260763,0.002594367647641304,226
testimony,1,225,9.320620007642909e-06,0.00445597496732285,226
judiciary,3,223,2.7961860022928726e-05,0.0044163663009466475,226
dow,218,7,0.002031895161666154,0.0001386303323167109,225
babies,139,86,0.0012955661810623643,0.0017031726541767338,225
stock,222,3,0.002069177641696726,5.941299956430467e-05,225
yes,168,56,0.0015658641612840086,0.0011090426585336872,224
screen,222,2,0.002069177641696726,3.960866637620311e-05,224
decline,193,31,0.0017988796614750813,0.0006139343288311483,224
touching,223,1,0.0020784982617043685,1.9804333188101555e-05,224
point,104,120,0.0009693444807948625,0.002376519982572187,224
idiot,184,40,0.0017149940814062952,0.0007921733275240623,224
momoa,223,1,0.0020784982617043685,1.9804333188101555e-05,224
jason,223,1,0.0020784982617043685,1.9804333188101555e-05,224
refused,195,29,0.0018175209014903672,0.0005743256624549452,224
obtained,2,221,1.8641240015285817e-05,0.004376757634570444,223
bolton,61,162,0.0005685578204662175,0.003208301976472452,223
🙄,218,5,0.002031895161666154,9.902166594050779e-05,223
cards,165,58,0.00153790230126108,0.0011486513249098903,223
arent,158,65,0.0014726579612075795,0.0012872816572266012,223
saved,9,214,8.388558006878618e-05,0.004238127302253733,223
released,119,104,0.0011091537809095062,0.002059650651562562,223
learned,160,62,0.0014912992012228654,0.0012278686576622966,222
proved,220,2,0.00205053640168144,3.960866637620311e-05,222
f,84,137,0.0007829320806420043,0.0027131936467699133,221
planning,206,15,0.0019200477215744391,0.00029706499782152337,221
borders,176,45,0.001640429121345152,0.00089119499346457,221
words,30,191,0.00027961860022928726,0.0037826276389273973,221
sorry,189,32,0.0017615971814445098,0.0006337386620192498,221
entering,146,75,0.0013608105211158647,0.0014853249891076167,221
message,121,99,0.0011277950209247919,0.0019606289856220543,220
urgent,2,218,1.8641240015285817e-05,0.0043173446350061396,220
wait,148,72,0.0013794517611311504,0.001425911989543312,220
friday,2,218,1.8641240015285817e-05,0.0043173446350061396,220
liberal,167,53,0.0015565435412763656,0.0010496296589693826,220
clintons,3,217,2.7961860022928726e-05,0.0042975403018180374,220
broker,218,2,0.002031895161666154,3.960866637620311e-05,220
cuts,192,28,0.0017895590414674385,0.0005545213292668436,220
questions,118,102,0.0010998331609018632,0.002020041985186359,220
iraq,184,35,0.0017149940814062952,0.0006931516615835545,219
meeting,5,214,4.660310003821454e-05,0.004238127302253733,219
youll,189,30,0.0017615971814445098,0.0005941299956430467,219
anyone,82,137,0.0007642908406267185,0.0027131936467699133,219
diversity,217,2,0.002022574541658511,3.960866637620311e-05,219
staring,218,1,0.002031895161666154,1.9804333188101555e-05,219
600,218,1,0.002031895161666154,1.9804333188101555e-05,219
hats,218,1,0.002031895161666154,1.9804333188101555e-05,219
betrayed,39,179,0.0003635041802980734,0.0035449756406701785,218
feels,216,2,0.002013253921650868,3.960866637620311e-05,218
related,39,179,0.0003635041802980734,0.0035449756406701785,218
talented,212,6,0.0019759714416202967,0.00011882599912860934,218
saw,155,63,0.0014446961011846508,0.001247672990850398,218
nice,166,52,0.0015472229212687228,0.001029825325781281,218
hungary,216,1,0.002013253921650868,1.9804333188101555e-05,217
hat,214,3,0.0019946126816355824,5.941299956430467e-05,217
pieces,216,1,0.002013253921650868,1.9804333188101555e-05,217
james,36,181,0.0003355423202751447,0.003584584307046382,217
prime,11,205,0.000102526820084072,0.004059888303560819,216
imagine,168,48,0.0015658641612840086,0.0009506079930288747,216
orban,215,1,0.0020039333016432254,1.9804333188101555e-05,216
transcript,3,213,2.7961860022928726e-05,0.004218322969065632,216
door,173,42,0.0016124672613222232,0.0008317819939002653,215
excited,164,51,0.001528581681253437,0.0010100209925931795,215
system,116,99,0.0010811919208865773,0.0019606289856220543,215
boy,156,58,0.0014540167211922936,0.0011486513249098903,214
gaga,213,1,0.0019852920616279393,1.9804333188101555e-05,214
dirty,193,21,0.0017988796614750813,0.00041589099695013267,214
guy,107,107,0.0009973063408177912,0.0021190636511268664,214
louisiana,102,112,0.0009507032407795766,0.0022180853170673744,214
native,211,3,0.0019666508216126537,5.941299956430467e-05,214
longer,39,175,0.0003635041802980734,0.003465758307917772,214
faith,176,37,0.001640429121345152,0.0007327603279597576,213
destroying,48,165,0.0004473897603668596,0.0032677149760367567,213
early,27,186,0.0002516567402063585,0.0036836059729868894,213
ford,210,3,0.0019573302016050106,5.941299956430467e-05,213
workforce,212,1,0.0019759714416202967,1.9804333188101555e-05,213
quashes,212,1,0.0019759714416202967,1.9804333188101555e-05,213
rumors,212,1,0.0019759714416202967,1.9804333188101555e-05,213
antifa,211,2,0.0019666508216126537,3.960866637620311e-05,213
head,101,111,0.0009413826207719338,0.0021982809838792727,212
promise,172,40,0.0016031466413145802,0.0007921733275240623,212
happened,63,149,0.0005871990604815032,0.002950845645027132,212
adding,186,26,0.001733635321421581,0.0005149126628906405,212
conservatives,201,11,0.0018734446215362245,0.00021784766506911712,212
understand,133,79,0.0012396424610165069,0.001564542321860023,212
several,43,169,0.00040078666032864504,0.003346932308789163,212
figures,210,2,0.0019573302016050106,3.960866637620311e-05,212
legs,5,207,4.660310003821454e-05,0.004099496969937022,212
talks,1,211,9.320620007642909e-06,0.004178714302689428,212
blue,135,76,0.0012582837010317927,0.0015051293222957183,211
maintains,210,1,0.0019573302016050106,1.9804333188101555e-05,211
bald,1,209,9.320620007642909e-06,0.004139105636313226,210
agent,144,66,0.0013421692811005788,0.0013070859904147027,210
sondland,1,209,9.320620007642909e-06,0.004139105636313226,210
challenges,1,208,9.320620007642909e-06,0.004119301303125124,209
envoys,1,208,9.320620007642909e-06,0.004119301303125124,209
finally,146,63,0.0013608105211158647,0.001247672990850398,209
flying,167,42,0.0015565435412763656,0.0008317819939002653,209
ask,30,179,0.00027961860022928726,0.0035449756406701785,209
university,193,16,0.0017988796614750813,0.0003168693310096249,209
denied,171,38,0.0015938260213069373,0.0007525646611478592,209
night,45,163,0.00041942790034393086,0.003228106309660554,208
suggests,53,155,0.0004939928604050742,0.0030696716441557413,208
breakthemup,207,1,0.001929368341582082,1.9804333188101555e-05,208
gives,191,17,0.0017802384214597954,0.00033667366419772645,208
beto,34,173,0.0003169010802598589,0.0034261496415415693,207
august,2,205,1.8641240015285817e-05,0.004059888303560819,207
bitter,193,14,0.0017988796614750813,0.0002772606646334218,207
disarray,2,205,1.8641240015285817e-05,0.004059888303560819,207
russians,5,202,4.660310003821454e-05,0.0040004753039965145,207
eagle,1,206,9.320620007642909e-06,0.00407969263674892,207
wars,198,9,0.0018454827615132958,0.000178238998692914,207
manhattan,1,205,9.320620007642909e-06,0.004059888303560819,206
ready,71,135,0.0006617640205426465,0.0026735849803937103,206
total,85,121,0.0007922527006496473,0.002396324315760288,206
shocking,195,11,0.0018175209014903672,0.00021784766506911712,206
towns,205,1,0.0019107271015667963,1.9804333188101555e-05,206
messages,6,199,5.592372004585745e-05,0.00394106230443221,205
wrote,26,178,0.00024233612019871562,0.0035251713074820772,204
speech,165,39,0.00153790230126108,0.0007723689943359607,204
completely,123,81,0.0011464362609400777,0.001604150988236226,204
remember,67,137,0.0006244815405120748,0.0027131936467699133,204
minister,9,195,8.388558006878618e-05,0.0038618449716798036,204
try,70,133,0.0006524434005350035,0.002633976314017507,203
kid,191,12,0.0017802384214597954,0.0002376519982572187,203
dearborn,2,201,1.8641240015285817e-05,0.003980670970808413,203
release,28,175,0.00026097736021400144,0.003465758307917772,203
prospects,103,100,0.0009600238607872196,0.0019804333188101556,203
igs,1,201,9.320620007642909e-06,0.003980670970808413,202
kidding,186,16,0.001733635321421581,0.0003168693310096249,202
clothes,201,1,0.0018734446215362245,1.9804333188101555e-05,202
matter,19,183,0.00017709178014521526,0.0036241929734225848,202
34,180,22,0.0016777116013757234,0.00043569533013823424,202
families,149,53,0.0013887723811387934,0.0010496296589693826,202
porter,1,201,9.320620007642909e-06,0.003980670970808413,202
wrong,91,111,0.0008481764206955047,0.0021982809838792727,202
sweet,195,6,0.0018175209014903672,0.00011882599912860934,201
2017,13,188,0.00012116806009935781,0.0037232146393630927,201
folmer,1,200,9.320620007642909e-06,0.003960866637620311,201
kept👇👇report,200,1,0.0018641240015285817,1.9804333188101555e-05,201
pride,200,1,0.0018641240015285817,1.9804333188101555e-05,201
stalker,199,1,0.0018548033815209387,1.9804333188101555e-05,200
stands,193,7,0.0017988796614750813,0.0001386303323167109,200
‘western,199,1,0.0018548033815209387,1.9804333188101555e-05,200
stalled,1,199,9.320620007642909e-06,0.00394106230443221,200
governments,119,81,0.0011091537809095062,0.001604150988236226,200
unplanned,31,169,0.00028893922023693014,0.003346932308789163,200
god,170,30,0.0015845054012992945,0.0005941299956430467,200
result,97,103,0.0009041001407413622,0.00203984631837446,200
virginia,80,120,0.0007456496006114327,0.002376519982572187,200
gomitch,1,199,9.320620007642909e-06,0.00394106230443221,200
mitchhe,1,199,9.320620007642909e-06,0.00394106230443221,200
bring,124,75,0.0011557568809477206,0.0014853249891076167,199
post,75,124,0.0006990465005732181,0.002455737315324593,199
lie,117,82,0.0010905125408942203,0.0016239553214243275,199
kids”,198,1,0.0018454827615132958,1.9804333188101555e-05,199
trademarks,1,198,9.320620007642909e-06,0.003921257971244109,199
background,151,47,0.001407413621154079,0.0009308036598407732,198
soup,197,1,0.001836162141505653,1.9804333188101555e-05,198
elder,2,196,1.8641240015285817e-05,0.0038816493048679053,198
‘delighted,196,1,0.00182684152149801,1.9804333188101555e-05,197
crisis,121,76,0.0011277950209247919,0.0015051293222957183,197
details,16,181,0.00014912992012228654,0.003584584307046382,197
save,169,28,0.0015751847812916515,0.0005545213292668436,197
minutes,60,137,0.0005592372004585745,0.0027131936467699133,197
ref,194,2,0.0018082002814827243,3.960866637620311e-05,196
capitalist,195,1,0.0018175209014903672,1.9804333188101555e-05,196
princess,195,1,0.0018175209014903672,1.9804333188101555e-05,196
mob,188,8,0.0017522765614368667,0.00015843466550481244,196
😏93trilliongreennewdisaster,195,1,0.0018175209014903672,1.9804333188101555e-05,196
legislation,163,33,0.001519261061245794,0.0006535429952073513,196
including,75,121,0.0006990465005732181,0.002396324315760288,196
mission,28,168,0.00026097736021400144,0.0033271279756010613,196
hospital,21,174,0.00019573302016050108,0.003445953974729671,195
stamp,186,9,0.001733635321421581,0.000178238998692914,195
afte,2,193,1.8641240015285817e-05,0.0038222363053036002,195
ill,93,102,0.0008668176607107905,0.002020041985186359,195
onion,194,1,0.0018082002814827243,1.9804333188101555e-05,195
took,24,171,0.0002236948801834298,0.0033865409751653664,195
resistance,3,192,2.7961860022928726e-05,0.003802431972115499,195
rubes,194,1,0.0018082002814827243,1.9804333188101555e-05,195
nhl,193,1,0.0017988796614750813,1.9804333188101555e-05,194
lied,34,160,0.0003169010802598589,0.0031686933100962492,194
puck,193,1,0.0017988796614750813,1.9804333188101555e-05,194
buildings,193,1,0.0017988796614750813,1.9804333188101555e-05,194
emergency,170,24,0.0015845054012992945,0.0004753039965144374,194
drop,154,40,0.001435375481177008,0.0007921733275240623,194
tens,193,1,0.0017988796614750813,1.9804333188101555e-05,194
doctors,117,76,0.0010905125408942203,0.0015051293222957183,193
steal,178,15,0.0016590703613604378,0.00029706499782152337,193
nationals,191,2,0.0017802384214597954,3.960866637620311e-05,193
start,97,96,0.0009041001407413622,0.0019012159860577495,193
warned,6,187,5.592372004585745e-05,0.003703410306174991,193
slavery,187,6,0.0017429559414292239,0.00011882599912860934,193
things,41,152,0.0003821454203133592,0.0030102586445914367,193
architect,190,3,0.0017709178014521526,5.941299956430467e-05,193
giving,128,65,0.0011930393609782923,0.0012872816572266012,193
hunt,161,31,0.0015006198212305082,0.0006139343288311483,192
appealht,191,1,0.0017802384214597954,1.9804333188101555e-05,192
telling,81,111,0.0007549702206190756,0.0021982809838792727,192
par,5,187,4.660310003821454e-05,0.003703410306174991,192
assaulted,175,17,0.0016311085013375089,0.00033667366419772645,192
wife,5,186,4.660310003821454e-05,0.0036836059729868894,191
celebrities,111,80,0.001034588820848363,0.0015843466550481246,191
laws,134,57,0.0012489630810241497,0.0011288469917217886,191
adopting,190,1,0.0017709178014521526,1.9804333188101555e-05,191
wnd,190,1,0.0017709178014521526,1.9804333188101555e-05,191
worse,26,165,0.00024233612019871562,0.0032677149760367567,191
response,83,108,0.0007736114606343614,0.002138867984314968,191
raid,188,2,0.0017522765614368667,3.960866637620311e-05,190
ok,153,37,0.001426054861169365,0.0007327603279597576,190
nominee,1,189,9.320620007642909e-06,0.0037430189725511944,190
destroy,139,51,0.0012955661810623643,0.0010100209925931795,190
earth,175,15,0.0016311085013375089,0.00029706499782152337,190
seed,188,2,0.0017522765614368667,3.960866637620311e-05,190
lock,179,11,0.0016683909813680806,0.00021784766506911712,190
blackout,188,2,0.0017522765614368667,3.960866637620311e-05,190
insects,189,1,0.0017615971814445098,1.9804333188101555e-05,190
evil,166,23,0.0015472229212687228,0.0004554996633263358,189
liberals,103,86,0.0009600238607872196,0.0017031726541767338,189
avert,188,1,0.0017522765614368667,1.9804333188101555e-05,189
archive,188,1,0.0017522765614368667,1.9804333188101555e-05,189
dollars,142,47,0.001323528041085293,0.0009308036598407732,189
schools,170,19,0.0015845054012992945,0.0003762823305739296,189
continues,21,168,0.00019573302016050108,0.0033271279756010613,189
whole,112,77,0.0010439094408560058,0.0015249336554838198,189
diet,186,2,0.001733635321421581,3.960866637620311e-05,188
ecologists,187,1,0.0017429559414292239,1.9804333188101555e-05,188
u,54,134,0.000503313480412717,0.0026537806472056087,188
increase,167,21,0.0015565435412763656,0.00041589099695013267,188
avoid,148,40,0.0013794517611311504,0.0007921733275240623,188
manufacturing,187,1,0.0017429559414292239,1.9804333188101555e-05,188
mayor,39,148,0.0003635041802980734,0.0029310413118390304,187
attempt,86,101,0.0008015733206572901,0.0020002376519982572,187
quid,2,185,1.8641240015285817e-05,0.003663801639798788,187
carolina,33,154,0.00030758046025221596,0.0030498673109676396,187
obrien,1,186,9.320620007642909e-06,0.0036836059729868894,187
triggered,167,20,0.0015565435412763656,0.00039608666376203115,187
americas,45,141,0.00041942790034393086,0.0027924109795223195,186
reckless,1,185,9.320620007642909e-06,0.003663801639798788,186
seek,9,177,8.388558006878618e-05,0.0035053669742939756,186
abortions,182,4,0.0016963528413910093,7.921733275240622e-05,186
aborted,185,1,0.001724314701413938,1.9804333188101555e-05,186
dhs,68,118,0.0006338021605197178,0.0023369113161959836,186
potus,83,102,0.0007736114606343614,0.002020041985186359,185
veto,141,44,0.0013142074210776501,0.0008713906602764685,185
boycott,169,16,0.0015751847812916515,0.0003168693310096249,185
‘play,184,1,0.0017149940814062952,1.9804333188101555e-05,185
favors,40,145,0.00037282480030571634,0.002871628312274726,185
2x,184,1,0.0017149940814062952,1.9804333188101555e-05,185
talked,5,179,4.660310003821454e-05,0.0035449756406701785,184
cities,174,9,0.001621787881329866,0.000178238998692914,183
experiments,182,1,0.0016963528413910093,1.9804333188101555e-05,183
seven,172,10,0.0016031466413145802,0.00019804333188101558,182
moat,108,74,0.001006626960825434,0.0014655206559195152,182
career,8,174,7.456496006114327e-05,0.003445953974729671,182
refusing,1,181,9.320620007642909e-06,0.003584584307046382,182
fool,171,10,0.0015938260213069373,0.00019804333188101558,181
conviction,15,166,0.00013980930011464363,0.0032875193092248584,181
e,18,163,0.00016777116013757235,0.003228106309660554,181
permit,4,177,3.7282480030571634e-05,0.0035053669742939756,181
rallies,39,142,0.0003635041802980734,0.002812215312710421,181
enemy,169,12,0.0015751847812916515,0.0002376519982572187,181
actually,109,72,0.001015947580833077,0.001425911989543312,181
sitting,173,7,0.0016124672613222232,0.0001386303323167109,180
62,178,2,0.0016590703613604378,3.960866637620311e-05,180
reform,2,178,1.8641240015285817e-05,0.0035251713074820772,180
paso,2,178,1.8641240015285817e-05,0.0035251713074820772,180
canceled,130,50,0.0012116806009935782,0.0009902166594050778,180
process,7,173,6.524434005350036e-05,0.0034261496415415693,180
hits,151,28,0.001407413621154079,0.0005545213292668436,179
accounts,172,7,0.0016031466413145802,0.0001386303323167109,179
rick,3,176,2.7961860022928726e-05,0.003485562641105874,179
prepare,3,176,2.7961860022928726e-05,0.003485562641105874,179
close,108,70,0.001006626960825434,0.001386303323167109,178
stayed,140,38,0.001304886801070007,0.0007525646611478592,178
hhs,177,1,0.0016497497413527947,1.9804333188101555e-05,178
surprises,176,2,0.001640429121345152,3.960866637620311e-05,178
strength,170,7,0.0015845054012992945,0.0001386303323167109,177
iowa,2,175,1.8641240015285817e-05,0.003465758307917772,177
folks,89,88,0.0008295351806802189,0.001742781320552937,177
weve,56,121,0.0005219547204280029,0.002396324315760288,177
problem,52,125,0.00048467224039743125,0.0024755416485126944,177
friend,142,35,0.001323528041085293,0.0006931516615835545,177
otherwise,174,2,0.001621787881329866,3.960866637620311e-05,176
hammer,171,5,0.0015938260213069373,9.902166594050779e-05,176
march,95,81,0.0008854589007260763,0.001604150988236226,176
blow,4,172,3.7282480030571634e-05,0.0034063453083534676,176
thousand,5,171,4.660310003821454e-05,0.0033865409751653664,176
live,98,77,0.000913420760749005,0.0015249336554838198,175
undermines,1,174,9.320620007642909e-06,0.003445953974729671,175
rogue,110,65,0.00102526820084072,0.0012872816572266012,175
step,56,119,0.0005219547204280029,0.0023567156493840852,175
retribution,174,1,0.001621787881329866,1.9804333188101555e-05,175
allegedly,163,11,0.001519261061245794,0.00021784766506911712,174
sanctuary,165,9,0.00153790230126108,0.000178238998692914,174
pushing,7,167,6.524434005350036e-05,0.00330732364241296,174
falsely,38,136,0.0003541835602904305,0.0026933893135818116,174
reminder,13,161,0.00012116806009935781,0.0031884976432843505,174
founder,169,5,0.0015751847812916515,9.902166594050779e-05,174
lose,35,139,0.0003262217002675018,0.002752802313146116,174
iconic,173,1,0.0016124672613222232,1.9804333188101555e-05,174
universal,171,2,0.0015938260213069373,3.960866637620311e-05,173
blowback,1,172,9.320620007642909e-06,0.0034063453083534676,173
true😡these,172,1,0.0016031466413145802,1.9804333188101555e-05,173
yesterday,45,128,0.00041942790034393086,0.002534954648076999,173
harvey,171,1,0.0015938260213069373,1.9804333188101555e-05,172
dear,20,152,0.00018641240015285817,0.0030102586445914367,172
weinstein,171,1,0.0015938260213069373,1.9804333188101555e-05,172
washington,17,155,0.00015845054012992945,0.0030696716441557413,172
lot,50,122,0.00046603100038214543,0.00241612864894839,172
understood,1,171,9.320620007642909e-06,0.0033865409751653664,172
places,168,4,0.0015658641612840086,7.921733275240622e-05,172
board,4,168,3.7282480030571634e-05,0.0033271279756010613,172
13,141,31,0.0013142074210776501,0.0006139343288311483,172
hostile,156,15,0.0014540167211922936,0.00029706499782152337,171
dinner,151,20,0.001407413621154079,0.00039608666376203115,171
paying,127,44,0.0011837187409706495,0.0008713906602764685,171
suffering,168,3,0.0015658641612840086,5.941299956430467e-05,171
per,19,152,0.00017709178014521526,0.0030102586445914367,171
resolution,137,34,0.0012769249410470784,0.0006733473283954529,171
perry,10,161,9.320620007642909e-05,0.0031884976432843505,171
thursday,1,170,9.320620007642909e-06,0.0033667366419772647,171
withdrawal,1,170,9.320620007642909e-06,0.0033667366419772647,171
committees,1,169,9.320620007642909e-06,0.003346932308789163,170
treason,37,133,0.0003448629402827876,0.002633976314017507,170
emotional,168,2,0.0015658641612840086,3.960866637620311e-05,170
partisan,3,167,2.7961860022928726e-05,0.00330732364241296,170
season,124,46,0.0011557568809477206,0.0009109993266526716,170
pelosis,159,11,0.0014819785812152223,0.00021784766506911712,170
indicted,147,23,0.0013701311411235075,0.0004554996633263358,170
resort,1,169,9.320620007642909e-06,0.003346932308789163,170
student,138,32,0.0012862455610547214,0.0006337386620192498,170
halftime,169,1,0.0015751847812916515,1.9804333188101555e-05,170
maroon,168,1,0.0015658641612840086,1.9804333188101555e-05,169
fakenews,149,20,0.0013887723811387934,0.00039608666376203115,169
ignorant,155,14,0.0014446961011846508,0.0002772606646334218,169
primary,5,164,4.660310003821454e-05,0.003247910642848655,169
stadium,168,1,0.0015658641612840086,1.9804333188101555e-05,169
poor,29,140,0.0002702979802216443,0.002772606646334218,169
solemnly,168,1,0.0015658641612840086,1.9804333188101555e-05,169
admitted,162,7,0.0015099404412381512,0.0001386303323167109,169
supposedly,1,168,9.320620007642909e-06,0.0033271279756010613,169
leave,45,124,0.00041942790034393086,0.002455737315324593,169
lawmakers,3,165,2.7961860022928726e-05,0.0032677149760367567,168
journalists,144,24,0.0013421692811005788,0.0004753039965144374,168
suspected,167,1,0.0015565435412763656,1.9804333188101555e-05,168
aimed,162,6,0.0015099404412381512,0.00011882599912860934,168
scottish,2,166,1.8641240015285817e-05,0.0032875193092248584,168
worth,62,105,0.0005778784404738603,0.0020794549847506635,167
amendment,109,58,0.001015947580833077,0.0011486513249098903,167
changed,11,156,0.000102526820084072,0.003089475977343843,167
seeking,1,166,9.320620007642909e-06,0.0032875193092248584,167
sunday,147,20,0.0013701311411235075,0.00039608666376203115,167
turmoiltheyve,166,1,0.0015472229212687228,1.9804333188101555e-05,167
english,165,2,0.00153790230126108,3.960866637620311e-05,167
spirithahahahahahahahahaha,166,1,0.0015472229212687228,1.9804333188101555e-05,167
candidate,18,148,0.00016777116013757235,0.0029310413118390304,166
al,68,98,0.0006338021605197178,0.0019408246524339526,166
menace,164,2,0.001528581681253437,3.960866637620311e-05,166
gulag,165,1,0.00153790230126108,1.9804333188101555e-05,166
survey,1,165,9.320620007642909e-06,0.0032677149760367567,166
virginiaremember,165,1,0.00153790230126108,1.9804333188101555e-05,166
send,120,46,0.001118474400917149,0.0009109993266526716,166
amount,156,10,0.0014540167211922936,0.00019804333188101558,166
status,23,143,0.0002143742601757869,0.0028320196458985225,166
firm,34,131,0.0003169010802598589,0.002594367647641304,165
reagan,2,163,1.8641240015285817e-05,0.003228106309660554,165
wire,39,126,0.0003635041802980734,0.002495345981700796,165
male,160,5,0.0014912992012228654,9.902166594050779e-05,165
happy,148,17,0.0013794517611311504,0.00033667366419772645,165
cri,2,163,1.8641240015285817e-05,0.003228106309660554,165
relationships,1,164,9.320620007642909e-06,0.003247910642848655,165
passed,151,14,0.001407413621154079,0.0002772606646334218,165
wind,164,1,0.001528581681253437,1.9804333188101555e-05,165
rein,164,1,0.001528581681253437,1.9804333188101555e-05,165
risk,2,162,1.8641240015285817e-05,0.003208301976472452,164
fulminating,163,1,0.001519261061245794,1.9804333188101555e-05,164
business,93,71,0.0008668176607107905,0.0014061076563552106,164
reason,72,92,0.0006710846405502894,0.0018219986533053432,164
pleasure,163,1,0.001519261061245794,1.9804333188101555e-05,164
38they,1,163,9.320620007642909e-06,0.003228106309660554,164
pollamericans,1,163,9.320620007642909e-06,0.003228106309660554,164
dozen,62,102,0.0005778784404738603,0.002020041985186359,164
gitmo,159,5,0.0014819785812152223,9.902166594050779e-05,164
ivy,163,1,0.001519261061245794,1.9804333188101555e-05,164
urinal,163,1,0.001519261061245794,1.9804333188101555e-05,164
organization,11,153,0.000102526820084072,0.0030300629777795384,164
raising,95,69,0.0008854589007260763,0.0013664989899790075,164
entry,159,4,0.0014819785812152223,7.921733275240622e-05,163
removes,162,1,0.0015099404412381512,1.9804333188101555e-05,163
confidential,1,162,9.320620007642909e-06,0.003208301976472452,163
wrigley,162,1,0.0015099404412381512,1.9804333188101555e-05,163
restaurants,162,1,0.0015099404412381512,1.9804333188101555e-05,163
privately,1,162,9.320620007642909e-06,0.003208301976472452,163
hundreds,118,45,0.0010998331609018632,0.00089119499346457,163
mixing,142,21,0.001323528041085293,0.00041589099695013267,163
becoming,14,148,0.00013048868010700072,0.0029310413118390304,162
troughs,161,1,0.0015006198212305082,1.9804333188101555e-05,162
weapon,153,9,0.001426054861169365,0.000178238998692914,162
solve,9,153,8.388558006878618e-05,0.0030300629777795384,162
narrative,31,131,0.00028893922023693014,0.002594367647641304,162
upright,1,161,9.320620007642909e-06,0.0031884976432843505,162
entire,109,53,0.001015947580833077,0.0010496296589693826,162
rapidly,156,6,0.0014540167211922936,0.00011882599912860934,162
demands,125,37,0.0011650775009553636,0.0007327603279597576,162
church,149,12,0.0013887723811387934,0.0002376519982572187,161
lightpennsylvania,1,160,9.320620007642909e-06,0.0031686933100962492,161
january,145,16,0.0013514899011082217,0.0003168693310096249,161
analysis,13,148,0.00012116806009935781,0.0029310413118390304,161
vows,2,159,1.8641240015285817e-05,0.0031488889769081476,161
wrongdoing,1,160,9.320620007642909e-06,0.0031686933100962492,161
reduce,2,159,1.8641240015285817e-05,0.0031488889769081476,161
infants,160,1,0.0014912992012228654,1.9804333188101555e-05,161
apologizes,148,12,0.0013794517611311504,0.0002376519982572187,160
given,10,150,9.320620007642909e-05,0.0029706499782152333,160
decision,24,136,0.0002236948801834298,0.0026933893135818116,160
stand,67,93,0.0006244815405120748,0.0018418029864934447,160
port,158,1,0.0014726579612075795,1.9804333188101555e-05,159
zealand,158,1,0.0014726579612075795,1.9804333188101555e-05,159
character,11,148,0.000102526820084072,0.0029310413118390304,159
rideshare,158,1,0.0014726579612075795,1.9804333188101555e-05,159
sound,145,14,0.0013514899011082217,0.0002772606646334218,159
rejoicing,158,1,0.0014726579612075795,1.9804333188101555e-05,159
poof,158,1,0.0014726579612075795,1.9804333188101555e-05,159
biggest,55,103,0.00051263410042036,0.00203984631837446,158
lobster,157,1,0.0014633373411999367,1.9804333188101555e-05,158
middle,127,31,0.0011837187409706495,0.0006139343288311483,158
decade,150,8,0.0013980930011464362,0.00015843466550481244,158
teaches,156,1,0.0014540167211922936,1.9804333188101555e-05,157
jesus,139,18,0.0012955661810623643,0.000356477997385828,157
dirt,9,148,8.388558006878618e-05,0.0029310413118390304,157
moment,97,60,0.0009041001407413622,0.0011882599912860935,157
grab,148,9,0.0013794517611311504,0.000178238998692914,157
scum,153,4,0.001426054861169365,7.921733275240622e-05,157
sides,149,8,0.0013887723811387934,0.00015843466550481244,157
defend,103,54,0.0009600238607872196,0.001069433992157484,157
detail,76,81,0.000708367120580861,0.001604150988236226,157
therehate,155,1,0.0014446961011846508,1.9804333188101555e-05,156
father,119,37,0.0011091537809095062,0.0007327603279597576,156
jail💥democrats,155,1,0.0014446961011846508,1.9804333188101555e-05,156
fundamental,6,150,5.592372004585745e-05,0.0029706499782152333,156
debt,109,47,0.001015947580833077,0.0009308036598407732,156
k,131,24,0.001221001221001221,0.0004753039965144374,155
accusations,6,149,5.592372004585745e-05,0.002950845645027132,155
san,127,28,0.0011837187409706495,0.0005545213292668436,155
influence,92,63,0.0008574970407031476,0.001247672990850398,155
democra,2,153,1.8641240015285817e-05,0.0030300629777795384,155
lindsey,15,140,0.00013980930011464363,0.002772606646334218,155
magically,153,1,0.001426054861169365,1.9804333188101555e-05,154
lol,135,19,0.0012582837010317927,0.0003762823305739296,154
‘and,153,1,0.001426054861169365,1.9804333188101555e-05,154
taylor,1,153,9.320620007642909e-06,0.0030300629777795384,154
worst,125,29,0.0011650775009553636,0.0005743256624549452,154
thinking,16,138,0.00014912992012228654,0.002732997979958015,154
1st,57,97,0.0005312753404356458,0.001921020319245851,154
rush,151,2,0.001407413621154079,3.960866637620311e-05,153
bin,114,39,0.0010625506808712916,0.0007723689943359607,153
note,48,105,0.0004473897603668596,0.0020794549847506635,153
interview,62,91,0.0005778784404738603,0.0018021943201172418,153
fallen,151,1,0.001407413621154079,1.9804333188101555e-05,152
whats,66,86,0.0006151609205044319,0.0017031726541767338,152
patrons,151,1,0.001407413621154079,1.9804333188101555e-05,152
customer,151,1,0.001407413621154079,1.9804333188101555e-05,152
mexico,56,96,0.0005219547204280029,0.0019012159860577495,152
regarding,92,60,0.0008574970407031476,0.0011882599912860935,152
compared,139,13,0.0012955661810623643,0.00025745633144532023,152
dominos,150,1,0.0013980930011464362,1.9804333188101555e-05,151
quietly,40,111,0.00037282480030571634,0.0021982809838792727,151
steak,150,1,0.0013980930011464362,1.9804333188101555e-05,151
jedi,150,1,0.0013980930011464362,1.9804333188101555e-05,151
went,30,121,0.00027961860022928726,0.002396324315760288,151
progressive,150,1,0.0013980930011464362,1.9804333188101555e-05,151
stabbed,150,1,0.0013980930011464362,1.9804333188101555e-05,151
west,51,100,0.0004753516203897883,0.0019804333188101556,151
ukr,1,150,9.320620007642909e-06,0.0029706499782152333,151
sounded,3,148,2.7961860022928726e-05,0.0029310413118390304,151
alarm,1,150,9.320620007642909e-06,0.0029706499782152333,151
ah,11,140,0.000102526820084072,0.002772606646334218,151
‘star,149,1,0.0013887723811387934,1.9804333188101555e-05,150
feel,128,22,0.0011930393609782923,0.00043569533013823424,150
airport,1,149,9.320620007642909e-06,0.002950845645027132,150
needed,124,26,0.0011557568809477206,0.0005149126628906405,150
wi,7,143,6.524434005350036e-05,0.0028320196458985225,150
banning,121,29,0.0011277950209247919,0.0005743256624549452,150
independent,6,144,5.592372004585745e-05,0.002851823979086624,150
place,52,98,0.00048467224039743125,0.0019408246524339526,150
kahn,149,1,0.0013887723811387934,1.9804333188101555e-05,150
ends,51,98,0.0004753516203897883,0.0019408246524339526,149
sues,22,127,0.000205053640168144,0.002515150314888898,149
guts,120,29,0.001118474400917149,0.0005743256624549452,149
blowers,2,147,1.8641240015285817e-05,0.0029112369786509287,149
illegally,128,21,0.0011930393609782923,0.00041589099695013267,149
blasts,21,128,0.00019573302016050108,0.002534954648076999,149
medical,25,124,0.00023301550019107272,0.002455737315324593,149
caught,60,89,0.0005592372004585745,0.0017625856537410386,149
sends,147,2,0.0013701311411235075,3.960866637620311e-05,149
pentagon,82,67,0.0007642908406267185,0.0013268903236028043,149
hours,103,46,0.0009600238607872196,0.0009109993266526716,149
benefits,132,17,0.0012303218410088638,0.00033667366419772645,149
quoted,142,7,0.001323528041085293,0.0001386303323167109,149
generations,2,147,1.8641240015285817e-05,0.0029112369786509287,149
documents🤬,1,147,9.320620007642909e-06,0.0029112369786509287,148
scene,145,3,0.0013514899011082217,5.941299956430467e-05,148
deportation,116,32,0.0010811919208865773,0.0006337386620192498,148
n,31,117,0.00028893922023693014,0.0023171069830078823,148
allegations,7,141,6.524434005350036e-05,0.0027924109795223195,148
transcripts,1,147,9.320620007642909e-06,0.0029112369786509287,148
shit,73,75,0.0006804052605579324,0.0014853249891076167,148
performance,143,5,0.0013328486610929358,9.902166594050779e-05,148
up🔥breaking,1,147,9.320620007642909e-06,0.0029112369786509287,148
fixing,1,147,9.320620007642909e-06,0.0029112369786509287,148
ads,84,64,0.0007829320806420043,0.0012674773240384995,148
non,29,119,0.0002702979802216443,0.0023567156493840852,148
🔥cover,1,147,9.320620007642909e-06,0.0029112369786509287,148
face—from,1,147,9.320620007642909e-06,0.0029112369786509287,148
tonight,80,68,0.0007456496006114327,0.0013466946567909058,148
change—without,1,147,9.320620007642909e-06,0.0029112369786509287,148
wake,132,15,0.0012303218410088638,0.00029706499782152337,147
others,9,138,8.388558006878618e-05,0.002732997979958015,147
february,1,146,9.320620007642909e-06,0.002891432645462827,147
whet,1,146,9.320620007642909e-06,0.002891432645462827,147
warning,39,108,0.0003635041802980734,0.002138867984314968,147
headed,140,7,0.001304886801070007,0.0001386303323167109,147
cases,7,139,6.524434005350036e-05,0.002752802313146116,146
pressed,1,145,9.320620007642909e-06,0.002871628312274726,146
important,55,91,0.00051263410042036,0.0018021943201172418,146
ago,75,71,0.0006990465005732181,0.0014061076563552106,146
shoot,10,136,9.320620007642909e-05,0.0026933893135818116,146
bouncer,145,1,0.0013514899011082217,1.9804333188101555e-05,146
boar,1,145,9.320620007642909e-06,0.002871628312274726,146
wonder,77,69,0.000717687740588504,0.0013664989899790075,146
boardhands,1,145,9.320620007642909e-06,0.002871628312274726,146
effort,55,91,0.00051263410042036,0.0018021943201172418,146
britain,145,1,0.0013514899011082217,1.9804333188101555e-05,146
vile,142,4,0.001323528041085293,7.921733275240622e-05,146
seeks,120,25,0.001118474400917149,0.0004951083297025389,145
hashtag,3,142,2.7961860022928726e-05,0.002812215312710421,145
flashes,144,1,0.0013421692811005788,1.9804333188101555e-05,145
genera,1,144,9.320620007642909e-06,0.002851823979086624,145
taxation,144,1,0.0013421692811005788,1.9804333188101555e-05,145
bodies,138,7,0.0012862455610547214,0.0001386303323167109,145
badge,144,1,0.0013421692811005788,1.9804333188101555e-05,145
signaling,3,142,2.7961860022928726e-05,0.002812215312710421,145
misconduct,1,143,9.320620007642909e-06,0.0028320196458985225,144
democratssocialists,142,2,0.001323528041085293,3.960866637620311e-05,144
singhs,143,1,0.0013328486610929358,1.9804333188101555e-05,144
arrests,143,1,0.0013328486610929358,1.9804333188101555e-05,144
designer,143,1,0.0013328486610929358,1.9804333188101555e-05,144
38,12,132,0.0001118474400917149,0.0026141719808294053,144
funny,74,69,0.0006897258805655752,0.0013664989899790075,143
baker,1,142,9.320620007642909e-06,0.002812215312710421,143
bipartisan,1,142,9.320620007642909e-06,0.002812215312710421,143
fortifying,1,142,9.320620007642909e-06,0.002812215312710421,143
side,72,71,0.0006710846405502894,0.0014061076563552106,143
dig,5,138,4.660310003821454e-05,0.002732997979958015,143
terrorism,42,101,0.00039146604032100216,0.0020002376519982572,143
preventing,140,3,0.001304886801070007,5.941299956430467e-05,143
loyalty,4,138,3.7282480030571634e-05,0.002732997979958015,142
aides,1,141,9.320620007642909e-06,0.0027924109795223195,142
threat,18,124,0.00016777116013757235,0.002455737315324593,142
circle,3,139,2.7961860022928726e-05,0.002752802313146116,142
celery,141,1,0.0013142074210776501,1.9804333188101555e-05,142
advancement,141,1,0.0013142074210776501,1.9804333188101555e-05,142
purgatory,141,1,0.0013142074210776501,1.9804333188101555e-05,142
penitent,141,1,0.0013142074210776501,1.9804333188101555e-05,142
tweets,55,87,0.00051263410042036,0.0017229769873648355,142
ran,66,76,0.0006151609205044319,0.0015051293222957183,142
countri,1,141,9.320620007642909e-06,0.0027924109795223195,142
shenanigans,1,141,9.320620007642909e-06,0.0027924109795223195,142
registry”,140,1,0.001304886801070007,1.9804333188101555e-05,141
check”,140,1,0.001304886801070007,1.9804333188101555e-05,141
played,51,90,0.0004753516203897883,0.00178238998692914,141
arguments,5,136,4.660310003821454e-05,0.0026933893135818116,141
majority,94,47,0.0008761382807184334,0.0009308036598407732,141
whis,1,140,9.320620007642909e-06,0.002772606646334218,141
word,45,96,0.00041942790034393086,0.0019012159860577495,141
inside,46,95,0.0004287485203515738,0.0018814116528696478,141
incoherent,2,138,1.8641240015285817e-05,0.002732997979958015,140
room,41,99,0.0003821454203133592,0.0019606289856220543,140
moscowmitchs,1,139,9.320620007642909e-06,0.002752802313146116,140
gainpatheticdiplomats,1,139,9.320620007642909e-06,0.002752802313146116,140
controv,1,139,9.320620007642909e-06,0.002752802313146116,140
crookedchao,1,139,9.320620007642909e-06,0.002752802313146116,140
sign,86,54,0.0008015733206572901,0.001069433992157484,140
tomorrow,31,109,0.00028893922023693014,0.0021586723175030698,140
florida,107,33,0.0009973063408177912,0.0006535429952073513,140
council,138,2,0.0012862455610547214,3.960866637620311e-05,140
market,135,5,0.0012582837010317927,9.902166594050779e-05,140
undermined,1,139,9.320620007642909e-06,0.002752802313146116,140
resign,48,91,0.0004473897603668596,0.0018021943201172418,139
circuit,96,43,0.0008947795207337192,0.0008515863270883669,139
everything,65,74,0.0006058403004967891,0.0014655206559195152,139
loveless,138,1,0.0012862455610547214,1.9804333188101555e-05,139
marriage,138,1,0.0012862455610547214,1.9804333188101555e-05,139
wages,138,1,0.0012862455610547214,1.9804333188101555e-05,139
tlaib,40,99,0.00037282480030571634,0.0019606289856220543,139
financial,14,125,0.00013048868010700072,0.0024755416485126944,139
area,122,16,0.001137115640932435,0.0003168693310096249,138
racism,45,93,0.00041942790034393086,0.0018418029864934447,138
constitutionally,3,135,2.7961860022928726e-05,0.0026735849803937103,138
happen,46,92,0.0004287485203515738,0.0018219986533053432,138
25,57,81,0.0005312753404356458,0.001604150988236226,138
blexit,137,1,0.0012769249410470784,1.9804333188101555e-05,138
beyond,123,15,0.0011464362609400777,0.00029706499782152337,138
origins,3,135,2.7961860022928726e-05,0.0026735849803937103,138
jim,38,100,0.0003541835602904305,0.0019804333188101556,138
request,21,117,0.00019573302016050108,0.0023171069830078823,138
guess,37,101,0.0003448629402827876,0.0020002376519982572,138
los,136,2,0.0012676043210394356,3.960866637620311e-05,138
angeles,135,2,0.0012582837010317927,3.960866637620311e-05,137
ca,30,107,0.00027961860022928726,0.0021190636511268664,137
jones,41,96,0.0003821454203133592,0.0019012159860577495,137
waste,25,112,0.00023301550019107272,0.0022180853170673744,137
intellectually,2,135,1.8641240015285817e-05,0.0026735849803937103,137
insults,134,3,0.0012489630810241497,5.941299956430467e-05,137
meth,136,1,0.0012676043210394356,1.9804333188101555e-05,137
changes,1,136,9.320620007642909e-06,0.0026933893135818116,137
vest,136,1,0.0012676043210394356,1.9804333188101555e-05,137
sets,107,30,0.0009973063408177912,0.0005941299956430467,137
tanker,136,1,0.0012676043210394356,1.9804333188101555e-05,137
cr,126,10,0.0011743981209630064,0.00019804333188101558,136
vapid,1,135,9.320620007642909e-06,0.0026735849803937103,136
attorneys,2,134,1.8641240015285817e-05,0.0026537806472056087,136
barbra,135,1,0.0012582837010317927,1.9804333188101555e-05,136
streisand,135,1,0.0012582837010317927,1.9804333188101555e-05,136
van,46,90,0.0004287485203515738,0.00178238998692914,136
taliban,82,54,0.0007642908406267185,0.001069433992157484,136
standing,85,51,0.0007922527006496473,0.0010100209925931795,136
agencies,4,132,3.7282480030571634e-05,0.0026141719808294053,136
offers,110,26,0.00102526820084072,0.0005149126628906405,136
